the
be	is	am	amn’t	isn’t	ain’t	been	bees	beings	was	wasn’t	were	weren’t
to
and
a	an
of
in	ins
i
that
you
it	its
have	haven’t	hasn’t	has	had	haves	having	havings
for
do	don’t	doesn’t	did	does	doing	doings	done
on
he	hes
with
this
as
we
not	n’t
but
they
say	said	sayings	says
at
what
his
from
go	goes	goings	gone	went
get	gets	getting	got	gotten
she
can	cann’t	caned	canes	caning	canned	canning	cans
all
there	theres
so	sos
her
about
one	ones
know	knew	knowes	knowings	known	knows
me	mes
your
who
like	liked	liker	likes	likest	likings
out	outed	outer	outings	outs
will	won’t	willed	willes	wills
their
would	wouldn’t
just	juster	justest
up	upped	upping	ups
when
make	made	makes	makings
more	mores
no	noes
think	thinkings	thinks
time	timed	times	timings
see	seeings	seen	sees
come	came	comes	comings
people	peopled	peoples	peopling
take	taked	takeing	taken	takes	takings	took
year	years
him
other	otherest
them
some
want	wanted	wanting	wantings	wants
how
now
which
right	righted	righter	rightest	righting	rightings	rights
could	couldn’t
look	looked	lookings	looks
than
our
into
here	heres
well	welled	weller	welling	wellings	wells
then	thens
because
use	used	uses	using
work	worked	workings	works	wrought
back	backed	backings	backs
way	ways
only
these
over	overest	overs
thing	things
good	gooder	goods
also
two	twos
first	firster	firsts
even	evened	evener	evenest	evenings	evens
need	needed	needing	needs
tell	tellings	tells	told
where
man	manes	manned	manning	mans	manses
after
day	days
find	findings	finds
give	gave	gived	givees	gives	givings
very
new	newer	newest
any
most	mostest
us
much	muches
those
down	downed	downing	downs
should
call	called	calles	callings	calls
many
really
mean	meaned	meaner	meanes	meanest	meanings	means	meant
life
may
through
why	whys
before
try	tries	tried	trying
still	stilled	stiller	stillest	stilling	stillings	stills
let	lets	letting
something
too
state	stated	states	stating
show	showed	showings	shown	shows
last	lasted	laster	lasting	lastings	lasts
woman	womans	women
long	longed	longes	longest	longings	longs
little	littler	littles	littlest
off	offed	offings	offs
never
feel	feeless	feelings	feels
talk	talked	talkings	talks
world	worlds
help	helped	helpings	helps
such
great	greater	greatest	greats
yeah
child	children	childs
oh	ohs
ask	asked	asking	asks
own	owned	owning	owns
school	schooled	schooles	schoolings	schools
while	whiles
start	started	startings	starts
around
place	placed	places	placing	placings
leave	leaved	leaves	leavings
point	pointed	pointes	pointing	pointings	points
keep	keepings	keeps	kept
love	loved	loves	loving	lovings
home	homed	homes	homester	homing	homings
put	puts
change	changed	changes	changing
big	bigger	biggest
same	sames
another
high	higher	highest	highs
both	botherer
play	played	playings	plays
part	parted	partes	partings	parts
american	americans
three	threes
between
every
house	housed	houses	housings
become	became	becomed	becomes	becoming	becomings
happen	happened	happenings	happens
turn	turned	turnings	turns
each
family	families
run	ran	runes	running	runs
end	ended	endings	ends
old	older	oldest
president	presidents
yes	yeses
lot	lots
again
student	students
might	mights
seem	seemed	seeming	seemings	seems
hand	handed	handing	hands
hear	heard	heares	hearings	hears	hearsed	hearses	hearsing
problem	problems
live	lived	lives	livings
question	questioned	questionings	questions
believe	believed	believes	believing
country	countries
move	moved	moves	moving	movings
since
better	bettered	betterer	bettering	betterings	betters
always
next
far	farther
away
case	cased	cases	casings
week	weeks
group	grouped	groupings	groups
few	fewer	fewest
name	named	names	namings
kind	kinder	kindest	kinds
against
guy	guyed	guying	guys
study	studies	studied	studying	studys
sure	surer	surest
head	headed	headings	heads
night	nights
best	bested	bester	besting	bests
game	gamed	gamer	games	gamest	gamester	gamings
number	numbered	numberings	numbers
without
book	booked	bookings	books
bad	worse
write	writes	writings	written	wrote
bring	bringed	bringings	brings	brought
hold	holdings	holds
money	moneys
system	systems
government	governments
city	cities
company	companies	companying
story	stories	storys
today	todays
job	jobbed	jobbing	jobs
must	musterer	musts
okay	okayed	okaying	okays
friend	friends
during
face	faced	faces	facings
begin	began	begins	begun
under	underer
different
issue	issued	issues	issuing
open	opened	openest	openings	opens
word	worded	wordings	words
stop	stoped	stopes	stoping	stopings	stopped	stops
ever
though
report	reported	reportings	reports
set	sets
fact	facts
enough	enoughs
pay	paid	payed	paying	pays
anything
early	earliest	earlier
program	programed	programing	programmed	programs
second	seconded	secondes	seconding	seconds
read	readings	reads
course	coursed	courses	coursings
care	cared	cares	carings
nothing	nothings
small	smaller	smallest	smalls
until
month	months
kid	kidded	kidding	kids
close	closed	closes	closest	closings
once
public	publics
maybe
business	businesses
plan	planed	planes	planing	planned	plans
million	millioner	millions
large	larger	larges	largest
power	powered	powering	powers
room	roomed	rooming	rooms
hard	harder	hardest
idea	ideas
support	supported	supportings	supports
team	teamed	teaming	teamings	teams
percent	percents
law	laws
line	lined	lines	linings
watch	watched	watches	watchings
actually
eye	eyed	eyeing	eyes	eying
provide	provided	provides	providing
lose	losed	loses	losing	losings	lost
war	wares	warred	warring	wars
real	realer	reales	realest	reals	reis
understand	understanded	understandings	understands	understood
mother	mothered	mothering	motherings	mothers
wait	waited	waites	waitings	waits
water	watered	waterings	waters
side	sided	sider	sides	sidest	sidings
lead	leaded	leadings	leads
stand	standings	stands	stood
young	younger	youngest	youngs
service	serviced	services	servicing
yet
less	lesser
meet	meetest	meetings	meets	met
area	areas
important
person	persons
hey
result	resulted	resulting	results
thank	thanked	thanking	thankings	thanks
someone	someones
national	nationals
black	blacked	blacker	blackest	blackings	blacks
however
hour	hours
everything
win	wined	wines	wining	wins	won
least	leasts
four	fourer	fours	fourses
father	fathered	fathering	fathers
girl	girls
hope
force	forced	forces	forcing
sit	sat	sited	sites	siting	sits
experience	experienced	experiences	experiencing
create	created	creates	creating
information	informations
car	cars
learn	learned	learnings	learns	learnt
already
minute	minuter	minutes	minutest
kill	killed	killings	kills
fall	fallen	falling	fallings	falls
party	parties	partying
reason	reasoned	reasonings	reasons
cause	caused	causes	causing
include	included	includes	including
human	humaner	humanest	humans
together
level	leveled	levelest	leveling	levelled	levelling	levels
follow	followed	followings	follows
health	healths
control	controled	controling	controlled	controlling	controls
remember	remembered	remembering	remembers
often
speak	speakings	speaks	spoken
ago
past	pasterer	pasts
break	breakings	breaks	broken
member	members
walk	walked	walkings	walks
light	lighted	lightest	lightings	lights
community	communities
late	later
social	socials
stay	stayed	staying	stayings	stays
news	newses
allow	allowed	allowing	allows
body	bodies	bodied	bodying
base	based	baser	bases	basest	basing
mind	minded	minding	mindings	minds
continue	continued	continues	continuing
whether
deal	dealings	deals	dealt
spend	spendings	spends	spent
top	topped	tops
able	abler	ablest
political
almost
boy	boys
university	universities
center	centered	centerer	centerings	centers
offer	offered	offerings	offers
research	researched	researches	researching
white	whited	whiter	whites	whitest	whitings
add	added	adding	adds
whole	wholes
five	fives
probably
free	freed	freeings	freer	frees	freest
among
cut	cutest	cuts
sound	sounded	soundest	soundings	sounds
form	formed	formes	forming	formings	forms
die	died	dies	dying
post	posted	postings	posts
process	processed	processes	processing
buy	bought	buying	buys
matter	mattered	mattering	matters
food	foods
else
history	histories
morning	mornings
parent	parented	parenting	parentings	parents
office	offices
figure	figured	figures	figurings
act	acted	acting	acts
send	sended	sendings	sends
along
within
court	courted	courtings	courts
return	returned	returning	returns
low	lowed	lowest	lowing	lows
drive	driven	drives	drivings
please	pleased	pleases	pleasings
note	noted	notes	noting
door	doors
several
grow	grew	growed	growings	grown	grows
answer	answered	answering	answers
across
moment	moments
sense	sensed	senses	sensings
cost	costed	costes	costings	costs
age	aged	ageings	ages	agings
behind	behinder	behinds
consider	considered	considering	considerings	considers
pass	passed	passes	passing
step	stepped	stepping	steps
view	viewed	viewings	views
street	streets
everyone
test	tested	testings	tests
policy	policies
table	tabled	tables	tabling	tablings
record	recorded	recordings	records
sorry	sorriest	sorrier
general	generals
rather
wrong	wronged	wronger	wrongest	wronging	wrongs
market	marketed	marketings	markets
share	shared	shares	sharings
true	trued	trueing	truer	trues	truest	truing
teacher	teachers
data
build	builded	buildings	builds	built
vote	voted	votes	voting
hit	hits	hitting
death	deaths
easy	easiest	easier
education	educations
expect	expected	expecting	expectings	expects
tax	taxed	taxes	taxing
himself
either
clear	cleared	clearer	clearest	clearings	clears
pretty	prettiest	prettier
future	futures
effect	effected	effecting	effects
college	colleges
music	musics
police	policed	polices	policing
fight	fightings	fights	fought
republican	republicans
appear	appeared	appearing	appears
rate
sign	signed	signings	signs
class	classed	classes	classing
bit	bits
season	seasoned	seasonings	seasons
present	presented	presenting	presents
half	halfer	halfs
fire	fired	fires	firings
air	aired	airings	airs
heart	hearts
son	sons
art	arts
local	locals
individual	individuals
serve	served	serves	servings
miss	missed	misses	missing
possible	possibler	possibles	possiblest
cover	covered	coverings	covers	coversed
full	fulled	fullest	fulling	fulls
although
value	valued	values	valuing
reach	reached	reaches	reaching
foot	feet	footed	footings	foots
listen	listened	listenings	listens
require	required	requires	requiring	requirings
pick	picked	pickings	picks
design	designed	designings	designs
increase	increased	increases	increasing	increasings
interest	interested	interesting	interests
agree	agreed	agreeing	agrees	agreing
anyone
baby	babies	babied	babying
front	fronted	fronter	frontes	fronting	fronts
order	ordered	orderings	orders
focus	foci	focused	focuses	focusings	focussed	focusses	focussing
check	checked	checking	checks
model	modeled	modeless	modelings	modelled	modelling	models
decide	decided	decides	deciding
comment	commented	commenting	comments
sometimes
phone	phoned	phones	phoning
major	majored	majoring	majors
security	securities
eat	ate	eaten	eating	eats
instead
suggest	suggested	suggesting	suggests
sell	selles	selling	sells
nation	nations
couple	coupled	couples	couplings
action	actioned	actiones	actioning	actions
pull	pulled	pullings	pulls
official	officials
wife	wives
decision	decisions
receive	received	receives	receiving	receivings
fine	fineer	finer	finest
raise	raised	raises	raisings
field	fielded	fieldings	fields
outside	outsides
attack	attacked	attacking	attacks
project	projected	projecting	projectings	projects
soon
event	events
site
rule	ruled	rules	rulings
practice	practiced	practices	practicing
strong	stronger	strongest
remain	remained	remaining	remains
explain	explained	explaining	explains
claim	claimed	claiming	claims
price	priced	prices	pricing
voice	voiced	voices	voicings
rest	rested	restes	resting	restinging	restings	rests
church	churched	churches	churching	churchings
perhaps
relationship	relationships
six	sixes
movie	movies
position	positioned	positioning	positions
list	listed	listings	lists
likely
player	players
inside	insides
themselves
nice	nicer	nicest
film	filmed	filming	films
especially
star	stared	stares	staring	starings	starred	starring	stars
difference	differences
development	developments
former	formers
federal	federals
role	roles
type	typed	types	typings
space	spaced	spaces	spacings
myself
picture	pictured	pictures	picturing
effort	efforts
wear	weared	wearings	wears	wore	worn
quite
military	militaries
finally
department	departments
toward
leader	leaders
land	landed	landes	landings	lands
special	specialer	specialest	specials
dead	deader	deadest	deads
photo	photos
lie	lain	lied	lies	lying
patient	patienter	patientest	patients
catch	catched	catches	catchings	caught
drug	drugged	drugging	drugs
guess	guessed	guesses	guessings
arm	armed	arming	arms
town	towns
article	articled	articles	articling
approach	approached	approaches	approaching
charge	charged	charges	charging
chance	chanced	chancer	chances	chancing
road	roads
economic
color	coloreds	colorer	colorings	colors
press	pressed	presses	pressings
save	saved	saves	savings
situation	situations
join	joined	joinings	joins
choose	chooses	choosing	chose	chosen
happy	happiest	happier
science	sciences
ground	grounded	groundings	grounds
risk	risked	risking	risks
campaign	campaigned	campaigning	campaigns
teach	taught	teached	teaches	teachings
image	imaged	images	imagings
carry	carries	carried	carryed	carrying	carryings	carrys
develop	developed	developes	developing	develops
yourself
piece	pieced	pieces	piecing	piecings
brother	brethren	brothers
above	aboves
term	termed	termes	terming	terms
simply
evidence	evidenced	evidences	evidencing
middle	middled	middler	middles	middlings
society	societies
paper	papered	paperings	papers
energy	energies
personal	personals
stuff	stuffed	stuffings	stuffs
building
doctor	doctored	doctoress	doctoresses	doctoring	doctors
single	singled	singler	singles	singling	singlings
drop	dropped	dropping	drops
short	shorted	shorter	shortest	shorting	shorts
wonder	wondered	wondering	wonderings	wonders
activity	activities
exactly
product	products
ready	readies	readiest	readier	readying
realize	realized	realizes	realizing
throw	threw	throwes	throwing	throwings	thrown	throws
race	raced	races	racings
technology	technologies
source	sourced	sources	sourcing	sourcings
alone
produce	produced	produces	producing
choice	choicer	choices	choicest
near	neared	nearer	nearest	nearing	nears
describe	described	describes	describing
mom	moms
director	directors
international	internationals
certain	certainer	certainest
election	elections
current	currents
page	paged	pages	pagings
video	videos
measure	measured	measures	measurings
park	parked	parkings	parks
key	keyed	keying	keys
standard	standards
itself
response	responses
subject	subjected	subjecting	subjects
whatever
benefit	benefited	benefiting	benefits	benefitted	benefitting
visit	visited	visites	visitings	visits
store	stored	stores	storing
shoot	shootings	shoots
third	thirds
recent	recenter	recentest
oil	oiled	oiling	oils
available
opportunity	opportunities
rise	risen	rises	risings
release	released	releasees	releases	releasing
organization	organizations
character	charactered	charactering	characters
address	addressed	addresses	addressing	addrest
county	counties	countys
dad	dads
whose
challenge	challenged	challenges	challenging
industry	industries	industrys
condition	conditioned	conditionings	conditions
dog	dogged	dogging	dogs
deep	deeper	deepest	deeps
attention	attentions
forget	forgets	forgetting	forgot	forgotten
per
account	accounted	accountings	accounts
plant	planted	plantings	plants
push	pushed	pushes	pushing
author	authored	authoresses	authoring	authorings	authors
red	redder	reddest	reds
wall	walled	walling	wallings	walls
hair	hairs
sleep	sleepings	sleeps	slept
daughter	daughters
bank	banked	bankings	banks
review	reviewed	reviewing	reviews
common	commonest	commons
truth	truths
average	averaged	averager	averages	averaging
draw	drawings	drawn	draws	drew
private	privater	privates	privatest
husband	husbanded	husbanding	husbands
upon
period	periods
fear	feared	feares	fearing	fears
series
officer	officered	officeress	officering	officers
feature	featured	features	featuring
wish	wished	wishes	wishings
dark	darker	darkest	darks
computer	computers
thought	thoughts
economy	economies
goal	goals
board	boarded	boardings	boards
behavior	behaviors
certainly
nearly
complete	completed	completer	completes	completest	completing
culture	cultured	cultures	culturing
dream	dreamed	dreamings	dreams
north	northest	norths
blood	blooded	blooding	bloodings	bloods
interview	interviewed	interviewing	interviews
medical	medicals
everybody
drink	drank	drinkings	drinks
amount	amounted	amounting	amounts
difficult
language	languages
window	windows
population	populations
tree	treed	treeing	trees
gun	gunned	gunning	guns
judge	judged	judges	judging
worker	workers
date	dated	dates	datings
worry	worries	worried	worryings
earth	earthed	earthing	earths
total	totaled	totaler	totaling	totalled	totalling	totals
fast	fasted	faster	fastest	fastings	fasts
hundred	hundreder	hundreds
tonight	tonights
thousand	thousands
letter	lettered	letterings	letters
forward	forwarded	forwarder	forwardest	forwardings	forwards
hell	hells
bill	billed	billings	bills
mention	mentioned	mentioning	mentions
search	searched	searches	searching	searchings
simple	simpler	simples	simplesses	simplest
involve	involved	involves	involving
poor	poorer	poorest
score	scored	scores	scorings
concern	concerned	concerning	concerns
message	messaged	messages	messagings
laugh	laughed	laughing	laughings	laughs
left	lefter	leftest	lefts
nature	natures
administration	administrations
touch	touched	touches	touchings
sort	sorted	sortes	sortings	sorts
song	songs
enjoy	enjoyed	enjoying	enjoys
similar
smile	smiled	smiles	smilings
congress	congresses
fund	funded	fundings	funds
fun
finish	finished	finishes	finishings
hot	hotter	hottest
material	materials
seek	seeking	seeks	sought
travel	traveled	travelings	travelled	travelling	travels
analysis
bed	bedded	bedding	beds
defense	defenses
final	finals
cell	cells
fill	filled	filles	fillings	fills
performance	performances
hospital	hospitals
green	greened	greener	greenest	greenings	greens
trade	traded	trades	tradings
summer	summered	summering	summerings	summers
attempt	attempted	attempting	attempts
protect	protected	protecting	protects
century	centuries
factor	factored	factoress	factorings	factors
fail	failed	failings	fails
recently
example	examples	exampless
represent	represented	representing	represents
blue	blued	blueing	bluer	blues	bluest	bluings
animal	animals
natural	naturals
particular	particulars
range	ranged	ranges	ranging
sir	sirs
beyond
agency	agencies
floor	floored	floorings	floors
usually
significant
ability	abilities
mile	miles
statement	statements
access	accessed	accesses	accessing
notice	noticed	notices	noticing
entire	entires
democrat	democrats
serious
hurt	hurted	hurter	hurting	hurts
coach	coached	coaches	coachings	coachs
career	careered	careering	careers
billion	billions
ahead
dollar	dollars
sex	sexed	sexes	sexing
compare	compared	compares	comparing
south	souths
file	filed	files	filings
financial
identify	identifies	identified	identifying
beautiful	beautifuler	beautifulest
decade	decades
reduce	reduced	reduces	reducing
sister	sisters
lack	lacked	lacking	lacks
quality	qualities
quickly
fan	fanned	fanning	fans
promise	promised	promisees	promises	promising
sport	sported	sporting	sports
resource	resources
beat	beaten	beatings	beats
accept	accepted	accepting	accepts
enter	entered	enterings	enters
size	sized	sizer	sizes	sizings
thus	thuses
demand	demanded	demanding	demands
movement	movements
scene	scenes
stick	sticked	sticking	stickings	sticks	stuck
cool	cooled	coolest	cooling	cools
section	sectioned	sectioning	sections
chief	chiefer	chiefest	chiefs
hate
treatment	treatments
west	wests
hang	hanged	hangings	hangs	hung
rock	rocked	rocking	rockings	rocks
candidate	candidates
link	linked	linking	links
box	boxed	boxes	boxing
determine	determined	determines	determining
prove	proved	proven	proves	proving	provings
trust	trusted	trusting	trusts
somebody	somebodies
potential	potentials
knowledge	knowledges
impact	impacted	impacting	impacts
limit	limiteds	limites	limitings	limits
loss	losses
argue	argued	argues	arguing
meeting
cold	colder	coldest	colds
staff	staffed	staffing	staffs
card	carded	carding	cardings	cards
skill	skills
feeling
despite	despites
degree	degrees
crime	crimes
due	dues
treat	treated	treating	treatings	treats
occur	occurred	occurring	occurs
imagine	imagined	imagines	imagining	imaginings
network	networked	networking	networkings	networks
king	kings
ball	balled	balling	ballings	balls	ballsed	ballses	ballsing
photograph	photographed	photographess	photographing	photographs
seven	sevener	sevens
perfect	perfected	perfectest	perfecting	perfects
credit	credited	crediting	credits
foreign
debate	debated	debates	debating
disease	diseases
lady	ladies
ride	ridden	rode
discuss	discussed	discusses	discussing
track	tracked	trackings	tracks
direct	directed	directer	directest	directing	directs
stage
east	easts
professional	professionals
fly	flies	flown	flew	flying
lay	laid	laying	lays
recognize	recognized	recognizes	recognizing
apply	applies	applied	applying
prepare	prepared	prepares	preparing
huge	huger	hugest
clean	cleaned	cleanest	cleanings	cleans
success	successes
district	districted	districting	districts
cup	cupped	cupping	cups
physical
growth	growths
safe	safer	safes	safest
detail	detailed	detailing	details
worth	worths
trouble	troubled	troubles	troubling	troublings
pressure	pressured	pressures	pressuring
seat	seated	seatings	seats
block	blocked	blockings	blocks
theory	theories
respect	respected	respecting	respects
legal
shit	shat	shited	shiting	shits	shitted	shitting
count	counted	countesses	counting	counts
target	targeted	targeting	targets
strategy	strategies
clearly
property	properties
authority	authorities
method	methods
strike	striked	strikes	strikings	struck
region	regions
content	contented	contenting	contents
indicate	indicated	indicates	indicating
bar	bared	bares	baring	barred	bars
committee	committees
dress	dressed	dresses	dressings
train	trained	trainings	trains
influence	influenced	influences	influencing
wind	winded	windings	winds	windses
main	mainest	mains
march	marched	marcheses	marching
training
option	options
central	centraler	centralest	centrals
gain	gained	gaining	gainings	gains
eight	eighter	eights
particularly
contact	contacted	contacting	contacts
completely
station	stationed	stationing	stations
opinion	opinions
remove	removed	removes	removing
ten	tens
affect	affected	affecting	affects
exist	existed	existing	exists
pain	pained	paining	pains
online
purpose	purposed	purposes	purposing
living
union	unions
professor	professors
sun	sunned	sunning	suns
christian	christians
herself
trip	tripes	tripped	tripping	trips	tripses
artist	artists
employee	employees
avoid	avoided	avoiding	avoids
welcome	welcomed	welcomes	welcoming
environment	environments
club	clubbed	clubs
male	males
specific	specifics
fuck	fucked	fucking	fucks
version	versions
shot	shots
female	females
reality	realities
brain	brained	braining	brains
justice	justices
river	rivers
memory	memories
below
favorite	favorites
adult	adulter	adults
camera	camerae	cameras
global
various
arrive	arrived	arrives	arriving
stock	stocked	stockinged	stockinging	stockings	stocks
nobody	nobodies
argument	arguments
fit	fits	fitted	fittest
murder	murdered	murderesses	murdering	murders
roll	rolled	rollings	rolls
weapon	weapons
island	islands
absolutely
firm	firmed	firmer	firmest	firming	firms
discussion	discussions
except	excepted	excepting	excepts
associate	associated	associates	associating
anyway
spot	spots	spotted
respond	responded	responding	responds
mine	mined	mines	minings
ship	shipped	ships
conversation	conversations
manage	managed	manages	managing
army	armies
original	originals
assume	assumed	assumes	assuming	assumings
executive	executives
writer	writers
perform	performed	performings	performs
partner	partnered	partnering	partners
reveal	revealed	revealings	reveals
slow	slowed	slower	slowest	slowings	slows
marriage	marriages
operation	operations
indeed
necessary	necessaries
spring	sprang	springed	springes	springing	springings	springs	sprung
heat	heated	heatings	heats
secret	secretest	secrets
agent	agents
weight	weighted	weightings	weights
leg	legs
contain	contained	containing	contains
glass	glassed	glasses	glassing
association	associations
democratic
improve	improved	improves	improving
gas	gases	gassed	gasses	gassing
religious	religiouses
positive	positiver	positives	positivest