lawyer	lawyers
production	productions
title	titled	titles	titling	titlings
structure	structured	structures	structuring
handle	handled	handles	handless	handlings
relate	related	relates	relating
none	nones
bear	beared	beares	bearess	bearings	bears	born	borne
management	managements
cross	crossed	crosser	crosses	crossest	crossings
victim	victims
cancer	cancers
trial	trials
tomorrow	tomorrows
speech	speeches
bag	bagged	bagging	bags
item	items
struggle	struggled	struggles	struggling	strugglings
dance	danced	dances	dancings
feed	feedings	feeds
citizen	citizens
establish	established	establishes	establishing
english	englisher	englishes
politics
machine	machined	machines	machining
customer	customers
manager	managers
tie	tied	tieing	ties	tying
publish	published	publishes	publishings
popular
sing	singed	singes	singings	sings	sung
conference	conferences
straight	straighter	straightest	straights
senior	seniors
discover	discovered	discovering	discovers
budget	budgeted	budgeting	budgets
direction	directions
sunday	sundays
maintain	maintained	maintaining	maintains
shake	shaked	shaken	shakes	shakings
tough	tougher	toughest	toughs
wide	wider	widest
majority	majorities
peace	peaces
dinner	dinners
throughout
user	users
blow	blew	blowed	blowess	blowings	blown	blows	blowsed	blowses
conduct	conducted	conducting	conducts
fair	faired	fairer	fairest	fairing	fairings	fairs
therefore
tool	tooled	tooling	toolings	tools
text	texts
expert	experts
rich	richer	richest
owner	owners
shall
style	styled	styles	styling	stylings
shut	shuted	shutes	shuting	shuts	shutting
voter	voters
mountain	mountains
crazy	crazies	craziest	crazier
friday	fridays
hide	hidden	hid	hided	hides	hidings
attorney	attorneys
unless
mouth	mouthed	mouthes	mouthing	mouthings	mouths
nor
document	documented	documenting	documents
function	functioned	functioning	functions
shape	shaped	shapes	shapings
hello	hellos
insurance	insurances
freedom	freedoms
reader	readers
cry	cries	cried	crying	cryings
battle	battled	battles	battling
november	novembers
generation	generations
fish	fished	fishes	fishings
income	incomes
admit	admits	admitted	admitting
object	objected	objecting	objects
onto
sea	seas
screen	screened	screenings	screens
conservative	conservatives
skin	skinned	skinning	skins
surface	surfaced	surfacer	surfaces	surfacings
web	webbed	webbing	webs
threat	threats
mistake	mistaken	mistakes	mistakings	mistook
solution	solutions
scientist	scientists
obviously
radio	radioed	radioing	radios
refer	refered	referred	referring	refers
damage	damaged	damages	damaging
task	tasked	tasking	taskings	tasks
mark	marked	markings	marks
bottom	bottomed	bottomer	bottoming	bottoms
edge	edged	edges	edgings
investigation	investigations
jump	jumped	jumping	jumps
senator	senators
unit	units
july	julies
television	televisions
chair	chaired	chairing	chairs
modern	moderner	modernest	moderns
sexual
finger	fingered	fingerings	fingers
prevent	prevented	preventing	prevents
senate	senates
violence	violences
wave	waved	waves	wavings
audience	audiences
evening
whom
ring	rang	ringed	ringings	rings
contract	contracted	contracting	contracts
hall	halls
wake	waked	wakes	wakings	woke	woken
suffer	suffered	sufferings	suffers
civil	civiler	civilest
safety	safeties
weekend	weekended	weekending	weekendings	weekends
normal	normals
supply	supplies	supplied	supplying
host	hosted	hostessed	hostesses	hostessing	hosting	hostings	hosts
quick	quicker	quickest	quicks
survey	surveyed	surveyings	surveys
yard	yards
guard	guarded	guarding	guards
fat	fated	fates	fating	fats	fatter	fattest
tend	tended	tending	tends
shop	shopped	shops
round	rounded	roundest	roundings	rounds
shoulder	shouldered	shouldering	shoulderings	shoulders
pattern	patterned	patterning	patternings	patterns
surprise	surprised	surprises	surprising	surprisings
mission	missions
eventually
participant	participants
hotel	hotels
sample	sampled	samples	samplings
shift	shifted	shiftings	shifts
speed	sped	speeded	speedings	speeds
institution	institutions
faith	faiths
reflect	reflected	reflecting	reflects
folk	folks
separate	separated	separates	separating
exercise	exercised	exercises	exercising
daily	dailies
client	clients
traditional
council	councils
device	devices
environmental
responsibility	responsibilities
internet
october	octobers
excuse	excused	excuses	excusing
code
warm	warmed	warmest	warmings	warms
funny	funnies	funniest	funnier
band	banded	bandings	bands
spirit	spirited	spiriting	spiritings	spirits
immediately
investment	investments
blog	blogs
effective
previous
consumer	consumers
ice	iced	ices	icings
honor	honored	honoress	honoring	honors
element	elements
nuclear
correct	corrected	correcter	correctest	correcting	corrects
directly
reform	reformed	reforming	reforms
afraid
define	defined	defines	defining
soldier	soldiered	soldieress	soldierings	soldiers
commercial	commercials
heavy	heavies	heaviest	heavier
following
master	mastered	masterer	masterings	masters
announce	announced	announces	announcing
journal	journals
tear	teared	tearing	tears	torn
primary	primaries
collection	collections
governor	governors
cultural
successful
mass	massed	masser	masses	massing
suddenly
match	matched	matches	matching	matchings
labor	labored	labores	laboress	laboring	laborings	labors
capital	capitals
deliver	delivered	deliveress	delivering	delivers
saturday	saturdays
editor	editors
fresh	freshest
anybody
destroy	destroyed	destroying	destroys
suit	suited	suites	suitings	suits
critical
burn	burned	burnings	burns	burnt
agreement	agreements
powerful
researcher	researchers
concept	concepts
willing	willinger	willingest
scale	scaled	scales	scalings
marry	marries	marrying	marryings	marrys
easily
restaurant	restaurants
league	leagued	leagues	leaguing
express	expressed	expresser	expresses	expressing
corner	cornered	cornering	corners
plus	pluses	plusses
anymore
magazine	magazines
status	statuses
attend	attended	attendings	attends
replace	replaced	replaces	replacing
european	europeans
hill	hilled	hilling	hills
doubt	doubted	doubting	doubtings	doubts
kitchen	kitchens
fix	fixed	fixes	fixings
favor	favored	favoress	favoring	favors
crowd	crowded	crowding	crowds
achieve	achieved	achieves	achieving
request	requested	requesting	requests
generally
estimate	estimated	estimates	estimating
resident	residenter	residents
relation	relations
arrest	arrested	arresting	arrests
basic	basics
display	displayed	displaying	displays
neither
gold	golder	goldest	golds
double	doubled	doubles	doublings
driver	drivers
beginning	beginnings
spread	spreaded	spreadings	spreads
religion	religions
crisis	crises
hole	holed	holes	holing	holings
museum	museums
engage	engaged	engages	engaging
communication	communications
huh
encourage	encouraged	encourages	encouraging	encouragings
french	frenched	frenches	frenching
understanding
kick	kicked	kicking	kicks
belief	beliefs
debt	debts
abuse	abused	abuses	abusing
connection	connections
balance	balanced	balances	balancing
neighborhood	neighborhoods
refuse	refused	refuses	refusing
additional
desire	desired	desires	desiring
mostly
path	paths
indian	indians
apple	apples
complex	complexer	complexes	complexest
god	gods
gift	gifted	gifting	gifts
wonderful
library	libraries
prison	prisons
sweet	sweeter	sweetest	sweets
garden	gardened	gardenings	gardens
award	awarded	awarding	awards
overall	overalls
stare
camp	camped	campest	campings	camps
introduce	introduced	introduces	introducing
waste	wasted	wastes	wastings
plane
blame	blamed	blamer	blames	blaming
definitely
lake	lakes
conflict	conflicted	conflicting	conflicts
earn	earned	earning	earnings	earns
cook	cooked	cookings	cooks
vehicle	vehicles
recall	recalled	recalling	recalls
examine	examined	examinees	examines	examining
independent	independents
application	applications
grade	graded	grades	gradings
witness	witnessed	witnesses	witnessing
coffee	coffees
criminal	criminals
ignore	ignored	ignores	ignoring
steal	stealed	steales	stealings	steals	stolen
planet	planets
location	locations
bird	birded	birding	birdings	birds
stone	stoned	stones	stonings
border	bordered	bordering	borderings	borders
exchange	exchanged	exchanges	exchanging
principle	principles
promote	promoted	promotes	promoting
nine	niner	nines
launch	launched	launches	launchings
alive
possibility	possibilities
sky	skies	skyed	skying
otherwise
grant	granted	granting	grants
advantage	advantaged	advantages	advantaging
mix	mixed	mixes	mixing
remind	reminded	reminding	reminds
horse	horsed	horseess	horses	horsing	horsings
healthy	healthiest	healthier
stress	stressed	stresses	stressing
beach	beached	beaches	beaching
truck	trucked	truckings	trucks
novel	novels
basis
context	contexts
grab	grabbed	grabbing	grabs
highly
christmas	christmases
strength	strengths
extra	extras
monday	mondays
negative	negatived	negativer	negatives	negativing
suspect	suspected	suspecter	suspecting	suspects
purchase	purchased	purchases	purchasing
writing
smart	smarted	smarter	smartest	smarting	smarts
football	footballs
western	westerns
failure	failures
paint	painted	paintings	paints
reporter	reporters
catholic	catholics
commit	commits	committed	committing
vision	visions
truly
progress	progressed	progresses	progressing
sick	sicker	sickest	sicks
stupid	stupider	stupidest	stupids
afternoon	afternoons
collect	collected	collectings	collects
responsible
secretary	secretaries
apparently
institute	instituted	institutes	instituting
southern	southernest
totally
tip	tipped	tipping	tips
distance	distanced	distances	distancing
regular	regulars
hire	hired	hirees	hires	hiring	hirings
learning
map	mapped	maps
commission	commissioned	commissioning	commissions
contribute	contributed	contributes	contributing
copy	copies	copied	copying
newspaper	newspapers
foundation	foundations
variety	varieties
perspective	perspectives
presence	presences
guide	guided	guides	guiding	guidings
taste	tasted	tastes	tastings
lesson	lessons
appreciate	appreciated	appreciates	appreciating
observe	observed	observes	observing
schedule	scheduled	schedules	scheduling
print	printed	printings	prints
multiple	multiples
currently
guest	guests
apartment	apartments
quote	quoted	quotes	quoting
yesterday	yesterdays
survive	survived	survives	surviving
soul	souls
protection	protections
intelligence	intelligences
storm	stormed	storming	stormings	storms
dry	dries	driest	dried	dryest	drying	drys
somewhere	somewheres
smell	smelled	smellings	smells
academic	academics
reading
lift	lifted	lifting	lifts
leadership	leaderships
damn	damner	damning	damns
attitude	attitudes
pound	pounded	poundings	pounds
farm	farmed	farmings	farms
decline	declined	declines	declining
deny	denies	denied	denying
website	websites
poll	polled	polling	pollings	polls
boat	boated	boatings	boats
seriously
actual
dozen	dozener	dozens
regard	regarded	regarding	regards
alternative	alternatives
pack	packed	packings	packs
connect	connected	connecting	connects
climate	climates
flight	flighted	flighting	flights
graduate	graduated	graduates	graduating
dangerous
aspect	aspects
african	africans
gay	gayer	gayest	gays
fuel	fueled	fueling	fuelled	fuelling	fuels
quiet	quieted	quieter	quietest	quieting	quietings	quiets
january	januaries
liberal	liberals
wild	wildest	wilds
reference	referenced	references	referencing
volume	volumes
joke	joked	jokes	joking
theater	theaters
square	squared	squarer	squares	squarest	squaring	squarings
aware	awarer	awarest
quarter	quartered	quarterings	quarters
identity	identities
moral	moraler	morals
demonstrate	demonstrated	demonstrates	demonstrating
fully
appeal	appealed	appealing	appeals
tuesday	tuesdays
facility	facilities
flow	flowed	flowing	flows
rain	rained	raines	raining	rains
shoe	shoed	shoeing	shoeings	shoes
wow	wowed	wowing	wows
bowl	bowled	bowles	bowless	bowlings	bowls
august	auguster	augustest	augusts
russian	russians
appropriate	appropriated	appropriates	appropriating
winter	wintered	wintering	winters
cash	cashed	cashes	cashing
smoke	smoked	smokes	smokings
advance	advanced	advances	advancing
basically
forest	forested	foresting	forests
pair	paired	paires	pairings	pairs
minister	ministered	ministering	ministers
birth	birthed	birthings	births
twice
settle	settled	settles	settlings
pop	popped	popping	pops
background	backgrounded	backgrounding	backgrounds
ad	ads
giant	giants
ticket	ticketed	ticketing	tickets
presidential
operate	operated	operates	operating
muslim	muslims
native	natives
division	divisions
slowly
circle	circled	circles	circling	circlings
advice	advices
reaction	reactions
injury	injuries
email	emailed	emailing	emails
lock	locked	lockings	locks
painting
weather	weathered	weatherer	weathering	weatherings	weathers
captain	captained	captainess	captaining	captains
outcome	outcomes
annual	annuals
enemy	enemies
troop	trooped	trooping	troops
tour	toured	touring	tourings	tours
kiss	kissed	kisses	kissing
being
bus	bused	buses	busing
bet	bets	betted	betting
ear	ears
wood	woods
root	rooted	rootings	roots
lord	lorded	lording	lordings	lords
neighbor	neighbored	neighboress	neighboring	neighbors
tiny	tiniest	tinier
mental
software	softwares
glad	gladder	gladdest	glads
load	loaded	loadings	loads
finding
relative	relatives
transfer	transferred	transferring	transfers
temperature	temperatures
bright	brighter	brightest
procedure	procedures
select	selected	selecting	selects
cast	casted	castes	castings	casts
tradition	traditions
threaten	threatened	threatening	threatenings	threatens
egg	egged	egging	eggs
active	actives
strange	strangest
actor	actors
cat	cats
depend	depended	depending	depends
german	germans	germen	germens
aim	aimed	aiming	aims
affair	affairs
bay	bayed	baying	bays
category	categories
topic	topics
victory	victories
empty	emptier	empties	emptiest	emptied	emptyings	emptyses
evil	eviler	evilest	evils
towards
ensure	ensured	ensures	ensuring
expression	expressions
session	sessions
competition	competitions
possibly
technique	techniques
intend	intended	intendeds	intending	intends
wine
impossible	impossibles
escape	escaped	escapees	escapes	escaping
loan	loaned	loanings	loans
gather	gathered	gatherings	gathers
somehow
addition	additions
scientific
capture	captured	captures	capturing
sentence	sentenced	sentences	sentencing	sentencings
invite	invited	invitees	invites	inviting	invitings
participate	participated	participates	participating
youth	youths
signal	signaled	signalings	signalled	signalling	signals
lean	leaned	leanest	leanings	leans
recommend	recommended	recommending	recommends
fellow	fellows
medicine	medicined	medicines	medicining
broad	broader	broadest	broads
equal	equaled	equaling	equalled	equalling	equals
obvious
thursday	thursdays
repeat	repeated	repeatings	repeats
explore	explored	explores	exploring
extend	extended	extending	extends
inch	inched	inches	inching
frame	framed	frames	framings
cop	coped	copes	copings	copped	copping	cops	copses
belong	belonged	belongings	belongs
obtain	obtained	obtaining	obtains
conclusion	conclusions
tape
grand	grander	grandest	grands
chicken	chickens
assessment	assessments
aid	aided	aides	aiding	aids
defend	defended	defending	defends
trail	trailed	trailings	trails
representative	representatives
married	marrieds
slightly
village	villages
combine	combined	combines	combining
lunch	lunched	lunches	lunching
bone	boned	bones	boning	bonings
historical
meaning
ourselves
apart
honey	honeyed	honeying	honeys	honied
consequence	consequences
unique	uniquer	uniquest
familiar	familiars
moon	mooned	mooning	moons
regulation	regulations
scream	screamed	screaming	screams
classroom	classrooms
stretch	stretched	stretches	stretching
emerge	emerged	emerges	emerging
emergency	emergencies
experiment	experimented	experimenting	experiments
nod	nodded	nodding	nodes	nods
instruction	instructions
thinking
soviet	soviets
coast	coasted	coasting	coastings	coasts
sad	sadder	saddest
trend	trended	trending	trends
anywhere
bridge	bridged	bridges	bridging	bridgings
rush	rushed	rushes	rushings
busy	busier	busies	busiest	busied	busying
construction	constructions
wednesday	wednesdays
profit	profited	profiting	profitings	profits
deserve	deserved	deserves	deserving	deservings
famous
brown	browned	browner	brownest	brownings	browns
intervention	interventions
breath	breaths
traffic	trafficked	trafficking	traffics
confirm	confirmed	confirming	confirmings	confirms
plenty	plenties
lucky	luckiest	luckier
growing
insist	insisted	insisting	insists
proud	prouder	proudest
fourth	fourther	fourths
angry	angriest	angrier
supreme	supremer	supremest
bomb	bombed	bombes	bombings	bombs
neck	necked	neckings	necks
core	cored	cores	coring
baseball	baseballs
accident	accidents
duty	duties
revenue	revenues
expand	expanded	expanding	expands
pool	pooled	pooling	pools
terrible
relatively
corporate
soft	softer	softest
generate	generated	generates	generating
extremely
cheap	cheaper	cheapest
monitor	monitored	monitoring	monitors
forever
knock	knocked	knockings	knocks
prior	priors
prefer	prefered	preferred	preferring	prefers
plate
literature	literatures
mayor	mayors
importance	importances
danger	dangers
emotional
knee	knees
aside	asides
ass	asses
update	updated	updates	updating
luck	lucks
pocket	pocketed	pocketing	pockets
sight	sighted	sightings	sights
equipment	equipments
variable	variables
flower	flowered	flowerings	flowers
panel	paneled	paneless	panelings	panelled	panels
command	commanded	commanding	commands
studio	studios
expensive
engine	engines
adopt	adopted	adopting	adopts
via
hero	heroes	heros
nurse	nursed	nurses	nursings
reply	replies	replied	replying
critic	critics
terrorist	terrorists
solve	solved	solves	solving
cloud	clouded	cloudings	clouds
reserve	reserved	reserves	reserving
episode	episodes
requirement	requirements
politician	politicians
israeli	israelis
click	clicked	clicking	clickings	clicks
colleague	colleagues
disappear	disappeared	disappearing	disappears
beer	beers
predict	predicted	predicting	predicts
tired	tireder	tiredest
bond	bonded	bondings	bonds
democracy	democracies
setting	settings
ultimately
unfortunately
theme	themed	themes	theming
climb	climbed	climbings	climbs
dear	dearer	dears
volunteer	volunteered	volunteering	volunteers
educational
comfortable
sugar	sugared	sugaring	sugarings	sugars
swing	swinged	swinges	swingings	swings	swung
investigate	investigated	investigates	investigating
useful
digital
entirely
slip	sliped	slipes	sliping	slipped	slipping	slips
thin	thinned	thinnest	thins
afford	afforded	affording	affords
teaching
chairman	chairmaned	chairmaning	chairmans	chairmen
error	errors
tall	taller	tallest	talls
specifically
veteran	veterans
mess	messed	messes	messing
boss	bossed	bosses	bossing
universe	universes
crew	crewed	crewes	crewing	crews
acknowledge	acknowledged	acknowledges	acknowledging
crash	crashed	crashes	crashing
coverage	coverages
prime
channel	channeled	channeling	channelings	channelled	channelling	channels
assistant	assistants
locate	located	locates	locating
illegal
lip	lips
bottle	bottled	bottles	bottling	bottlings
initial	initialed	initialer	initialing	initialled	initialling	initials
zone	zoned	zones	zonings
wedding	weddings
protest	protested	protesting	protests
contrast	contrasted	contrasting	contrasts
fashion	fashioned	fashioning	fashions
meal	meals
minority	minorities
surround	surrounded	surrounding	surroundings	surrounds
switch	switched	switches	switchings
domestic	domestics
rank	ranked	rankes	rankest	rankings	ranks
careful
gender	genders
ocean	oceans
package	packaged	packages	packagings
unidentified
circumstance	circumstances
declare	declared	declares	declaring
chemical	chemicals
secure	secured	secures	securest	securing	securings
tea	teas
organize	organized	organizes	organizing
salt	salted	saltest	saltings	salts
rape
manner	manners
shadow	shadowed	shadowings	shadows
net	nets	netted
percentage	percentages
massive
winner	winners
honest	honester	honestest
component	components
propose	proposed	proposes	proposing
rely	relies	relied	relying
self	selfs	selves
vice	vices
label	labeled	labeling	labelled	labelling	labels
appearance	appearances
excellent
beauty	beauties
fee	fees
yours
shirt	shirted	shirtings	shirts
fruit	fruited	fruiting	fruitings	fruits
plastic	plastics
bother	bothered	bothering	bothers
tooth	tooths
meat	meats
significantly
february	februaries
nose	nosed	noses	nosing	nosings
constitution	constitutions
definition	definitions
immigrant	immigrants
uncle	uncles
metal	metaled	metaler	metaling	metals
album	albums
suppose	supposed	supposes	supposing	supposings
investor	investors
holy	holies	holiest	holier
palestinian	palestinians
desk	desks
chain	chained	chaines	chaining	chains
opposite	opposites
eastern
tight	tighter	tightest
valley	valleys
largely
abortion	abortions
classic	classics
chapter	chapters
snow	snowed	snowing	snows
wing	winged	winging	wings
commitment	commitments
celebrate	celebrated	celebrates	celebrating
peer	peered	peeresses	peering	peers
urban	urbaner	urbanest
shock	shocked	shocking	shocks
unlike
internal
proposal	proposals
capacity	capacities
guilty	guiltiest	guiltier
warn	warned	warnings	warns
weak	weaker	weakest
advocate	advocated	advocates	advocatess	advocating
holiday	holidayed	holidaying	holidays
divide	divided	divides	dividing	dividings
bunch	bunched	bunches	bunching	bunchings
convention	conventions
super	supers
silence	silenced	silences	silencing
jury	juries
incident	incidents
hearing
motion	motioned	motioning	motions
everywhere
magic	magics
pleasure	pleasures
payment	payments
conclude	concluded	concludes	concluding
brand	branded	branding	brands
surgery	surgeries
essential	essentials
increasingly
route	routeing
chest	chests
slide	slidden	slid	slided	slides	sliding	slidings
amendment	amendments
besides
fault	faulted	faulting	faults
complain	complained	complaining	complainings	complains
extent	extents
permit	permits	permitted	permitting
leaf	leafed	leafing	leafs
draft	drafted	draftings	drafts
talent	talents
necessarily
expectation	expectations
accuse	accused	accuses	accusing
previously
wrap	wrapped	wraps
arab	arabs
corporation	corporations
sector	sectors
brief	briefed	briefer	briefest	briefings	briefs
jail	jailed	jailing	jails
yellow	yellowed	yellower	yellowest	yellowing	yellows
wash	washed	washes	washings
mirror	mirrored	mirroring	mirrors
finance	financed	finances	financings
cycle	cycled	cycles	cyclings
farmer	farmers
rare	rarer	rarest
confidence	confidences
ancient	ancienter	ancientest	ancients
bite	bited	bites	biting	bitings	bitten
creative
breast	breasted	breasting	breasts
cite	cited	cites	citess	citesses	citing
northern	northerns
speaker	speakers
usual
contribution	contributions
wheel	wheeled	wheelings	wheels
implement	implemented	implementing	implements
interaction	interactions
hat	hated	hates	hating	hats	hatted	hatting
weird	weirder	weirdest	weirds
pursue	pursued	pursues	pursuing	pursuings
gene	genes
difficulty	difficulties
hardly
flat	flats	flattest
daddy	daddies
era	eras
calm	calmed	calmer	calmest	calming	calms
encounter	encountered	encountering	encounters
invest	invested	investing	invests
personally
notion	notions
explanation	explanations
row	rowed	rowing	rows
airport	airports
solid	solider	solidest	solids
crack	cracked	crackings	cracks
expose	exposed	exposes	exposing
convince	convinced	convinces	convincing
seed	seeded	seeding	seedings	seeds
carefully
estate	estates
characteristic	characteristics
branch	branched	branches	branchings
forth
spending
birthday	birthdays
pray	prayed	praying	prayings	prays
improvement	improvements
loud	louder	loudest
ought
engineer	engineered	engineerings	engineers
muscle	muscled	muscles	muscling	musclings
pitch	pitched	pitches	pitchings
sheet	sheeted	sheetings	sheets
length	lengths
elect	elected	electing	elects
funding
meanwhile	meanwhiles
barely
eliminate	eliminated	eliminates	eliminating
pilot	piloted	pilotings	pilots
comparison	comparisons
combination	combinations
limited
description	descriptions
regional
somewhat
narrow	narrowed	narrower	narrowest	narrowings	narrows
chase	chased	chases	chasing	chasings
bike	biked	bikes	biking	bikings
reject	rejected	rejecting	rejects
proper	properer	properest
marketing
approve	approved	approves	approving
orange	oranger	oranges	orangest
false	falser	falsest
instrument	instrumented	instrumenting	instruments
license	licensed	licensees	licenses	licensing
creation	creations
typically
thick	thicker	thickest	thicks
inspire	inspired	inspires	inspiring
upset	upsets	upsetting
tone	toned	tones	toning	tonings
given	givens
noise	noised	noises	noising
dig	digging	digs	dug
golden	goldener	goldenest
inform	informed	informing	informs
perception	perceptions
visitor	visitors
diet	dieted	dieting	diets
judgment	judgments
glance	glanced	glances	glancing	glancings
joint	jointed	jointing	jointings	joints
regime	regimes
merely
producer	producers
whoa
typical
analyst	analysts
milk	milked	milking	milkings	milks
opening
objective	objectives
disability	disabilities
stream	streamed	streamings	streams
employ	employed	employes	employing	employs
rating
campus	campuses	campusses
assess	assessed	assesses	assessing
delay	delayed	delaying	delays
mad	maddest
gentleman	gentlemen	gentlemens
opposition	oppositions
wage
narrative	narratives
soil	soiled	soilings	soils
extreme	extremer	extremes	extremest
athlete	athletes
journey	journeyed	journeyings	journeys
flash	flashed	flashes	flashest	flashings
anger	angered	angering	angers
prayer	prayers
frequently
basketball	basketballs
revolution	revolutions
emotion	emotions
dish	dished	dishes	dishing	dishings
ban	banes	bani	banned	banning	bans
platform	platforms
gray	grayed	grayer	grayest	graying	grays
tank	tanked	tanking	tankings	tanks
marine	marines
enable	enabled	enables	enabling
till	tilled	tillings	tills
legislation	legislations
lab	labs
guarantee	guaranteed	guaranteeing	guarantees	guaranteing
oppose	opposed	opposes	opposing
collapse	collapsed	collapses	collapsing
immigration	immigrations