edit	edited	editing	edits
candy	candies	candied	candying	candys
sandwich	sandwiched	sandwiches	sandwiching
nerve	nerved	nerves	nerving	nervings
lung	lungs
scout	scouted	scoutings	scouts
foster	fostered	fosterer	fosterings	fosters
successfully
defendant	defendants
satisfy	satisfies	satisfied	satisfying
aircraft	aircrafts
withdraw	withdrawing	withdrawn	withdraws	withdrew
cabinet	cabinets
repeatedly
happiness	happinesses
fade	faded	fades	fadings
admission	admissions
correlation	correlations
counselor	counselors
rapid	rapider	rapidest	rapids
explosion	explosions
appoint	appointed	appointing	appoints
cognitive
furniture	furnitures
significance	significances
grateful
grin	grinned	grinning	grins
commissioner	commissioners
shelf	shelfs
tremendous
warrior	warriors
mate
gut	guts
spill	spilled	spilling	spillings	spills	spilt
garage	garaged	garages	garaging	garagings
prominent
spark	sparked	sparkes	sparking	sparks
fifty	fifties
oven	ovens
satisfaction	satisfactions
discrimination	discriminations
recession	recessions
allegation	allegations
scratch	scratched	scratches	scratchings
crush	crushed	crushes	crushing
lately
restriction	restrictions
diamond	diamonds
slam	slammed	slamming	slams
pale	paler	palest
chat	chats	chatted	chatting
subsequent
nonprofit	nonprofits
meter	metered	metering	meters
conviction	convictions
tweet	tweeted	tweeting	tweets
fame	fames
standing
behalf	behalves
contrary	contraries
playoff	playoffs
actress	actresses
harbor	harbored	harboring	harbors
controversy	controversies
auto	autos
shore	shored	shores	shorings
grocery	groceries
flame	flamed	flames	flamings
regulate	regulated	regulates	regulating
barrel	barreled	barreling	barrelled	barrelling	barrels
soup	souped	souping	soups
trash	trashed	trashes	trashing
celebration	celebrations
handful	handfuls
frequent	frequented	frequentest	frequenting	frequents
copyright	copyrighted	copyrighting	copyrights
import	imported	importing	imports
signature	signatures
bishop	bishops
retail	retailed	retailings	retails
strengthen	strengthened	strengthenings	strengthens
brave	braved	braver	braves	bravest	braving
entitle	entitled	entitles	entitling
whoever
carrier	carriers
anniversary	anniversaries
pizza	pizzas
shrug	shrugged	shrugging	shrugs
legend	legends
eagle	eagled	eagles	eagless	eagling
scholarship	scholarships
pit	pits	pitted	pitting
membership	memberships
treaty	treaties
partly
consciousness	consciousnesses
manufacturing
announcement	announcements
tire	tires	tiring	tirings
makeup	makeups
drift	drifted	drifting	drifts
prediction	predictions
stability	stabilities
stack	stacked	stacking	stackings	stacks
norm	norms
bloody	bloodier	bloodies	bloodiest	bloodied	bloodying
genius	genii	geniuses
gently
interrupt	interrupted	interrupting	interrupts
operator	operators
mall	malls
poet	poets
tendency	tendencies
bull	bulled	bulling	bullings	bulls
explode	exploded	explodes	exploding
controversial
maintenance	maintenances
courage	courages
warrant	warranted	warranting	warrantings	warrants
exceed	exceeded	exceeding	exceeds
vaccine	vaccines
identification	identifications
tunnel	tunneled	tunneling	tunnelings	tunnelled	tunnelling	tunnels
butt	butted	buttes	butting	butts
blanket	blanketed	blanketer	blanketing	blanketings	blankets
lens	lenses
twelve	twelves
rifle	rifled	rifles	riflings
ritual	rituals
presidency	presidencies
snake	snaked	snakes	snaking
editorial	editorials
integrity	integrities
distinct	distincter	distinctest
intelligent
hypothesis	hypotheses
fifteen	fifteener	fifteens
rage	ragees
nomination	nominations
adjustment	adjustments
skip	skipped	skipping	skips
render	rendered	renderings	renders
acceptable
mutual
examination	examinations
meaningful
currency	currencies
beam	beamed	beaming	beamings	beams
rope	roped	ropes	ropings
guitar	guitars
doctrine	doctrines
harvest	harvested	harvesting	harvests
commerce	commerces
invent	invented	inventing	invents
robot	robots
discourse	discoursed	discourses	discoursing
smoking
respectively
particle	particles
jazz	jazzed	jazzes	jazzing
glove	gloves
input	inputs
driving
spray	sprayed	spraying	sprays
infant	infants
summary	summaries
server	servers
leather	leathered	leathering	leatherings	leathers
spy	spies	spied	spying
radiation	radiations
monthly	monthlies
composition	compositions
tent	tented	tentings	tents
assert	asserted	asserting	asserts
wildlife	wildlifes
soccer	soccers
rail	railed	railes	railings	rails
nightmare	nightmares
olive	olives
blend	blended	blendes	blendings	blends
homeless
globe	globes
uncomfortable
execute	executed	executes	executing
reporting
patent	patented	patenter	patenting	patents
pledge	pledged	pledgees	pledges	pledging
receiver	receivers
closet	closeted	closeting	closets
horizon	horizons
resume	resumed	resumeing	resumes	resuming
wander	wandered	wanderings	wanders
diagnosis
suffering
considerable
grain	grained	graines	grainings	grains
gospel	gospels
automatically
fighting
crown	crowned	crowning	crownings	crowns
swallow	swallowed	swallowing	swallows
dose	dosed	doses	dosing
beast	beasts
lap	lapped	lapping	laps
fabric	fabrics
civilization	civilizations
corruption	corruptions
consent	consented	consenting	consents
toe	toed	toeing	toes
upgrade	upgraded	upgrades	upgrading	upgradings
greatly
workshop	workshops
telescope	telescoped	telescopes	telescoping
inquiry	inquiries
alright
admire	admired	admires	admiring
exclude	excluded	excludees	excludes	excluding
bare	barer	barest
touchdown	touchdowns
experimental
hunter	hunters
upstairs
corps	corpses
behave	behaved	behaves	behaving
iranian	iranians
awake	awaked	awakes	awaking	awakings	awoke	awoken
cave	caved	caves	caving	cavings
motivate	motivated	motivates	motivating
elderly	elderlies
virtual
weakness	weaknesses
doc	docs
virtue	virtues
curse	curses	cursing	cursings	curst
convict	convicted	convicting	convicts
ounce	ounces
athletic
blade	blades
confusion	confusions
legislative
facilitate	facilitated	facilitates	facilitating
midnight	midnights
deer	deers
undergo	undergoes	undergoing	undergone	undergos	underwent
heritage	heritages
summit	summited	summiting	summits
sword	swords
donate	donated	donates	donating
agriculture	agricultures
premium	premiums
enforce	enforced	enforces	enforcing
divine	divined	divines	divinest	divining
melt	melted	meltings	melts	molten
gross	grossed	grosser	grosses	grossest	grossing
bump	bumped	bumping	bumpings	bumps
deadly	deadliest	deadlier
integrate	integrated	integrates	integrating
fancy	fancies	fanciest	fancied	fancying
retreat	retreated	retreating	retreats
prescription	prescriptions
adoption	adoptions
reliable
transaction	transactions
lawn	lawns
consistently
briefly
absorb	absorbed	absorbing	absorbs
princess	princesses
kingdom	kingdoms
anticipate	anticipated	anticipates	anticipating
dedicate	dedicated	dedicatees	dedicates	dedicating
nominee	nominees
transformation	transformations
feminist	feminists
temple	temples
beef	beefed	beefing	beefs	beeves
arrival	arrivals
frustration	frustrations
dominant	dominants
demonstration	demonstrations
pollution	pollutions
poster	posters
worship	worshiped	worshiping	worshipped	worshipping	worships
guidance	guidances
stamp	stamped	stamping	stampings	stamps
lemon	lemons
bankruptcy	bankruptcies
grasp	grasped	grasping	grasps
resign	resigned	resigning	resigns
invasion	invasions
coin	coined	coining	coinings	coins
sacred
replacement	replacements
portray	portrayed	portraying	portrays
chronicle	chronicled	chronicles	chronicling
deposit	deposited	depositing	deposits
overlook	overlooked	overlooking	overlooks
distinguish	distinguished	distinguishes	distinguishing
glory	glories	gloried	glorying
consensus	consensuses
patrol	patrolled	patrolling	patrols
hardware	hardwares
nursing
cabin	cabined	cabining	cabins
costume	costumed	costumes	costuming
tobacco	tobaccoes	tobaccos
precious
orientation	orientations
wherever
seize	seized	seizes	seizings
punish	punished	punishes	punishing
sexy	sexiest	sexier
depict	depicted	depicting	depicts
seemingly
brick	bricks
widespread
competitor	competitors
freshman	freshmen
bounce	bounced	bounces	bouncing
hammer	hammered	hammerings	hammers
donation	donations
administrative
donor	donors
gradually
toilet	toilets
resemble	resembled	resembles	resembling
ideology	ideologies
organ	organs
starting
thumb	thumbed	thumbing	thumbs
reservation	reservations
oak	oaks
valid	valider	validest
warming
instructor	instructors
powder	powdered	powdering	powders
racism	racisms
pension	pensioned	pensiones	pensioning	pensions
diabetes
shell	shelled	shellings	shells
eager	eagerer	eagerest	eagers
marijuana	marijuanas
exclusive	exclusives
sixth	sixths
inspiration	inspirations
franchise	franchised	franchisees	franchises	franchising
cooking
helicopter	helicopters
conspiracy	conspiracies
trait	traits
van	vans
institutional
garlic	garlics
drinking
crystal	crystals
bath	bathed	bathes	bathings	baths
equation	equations
timing
pope	popes
slap	slapped	slapping	slaps
opera	operas
ethical
pine
indication	indications
motive
porch	porches
reinforce	reinforced	reinforces	reinforcing
ours
boil	boiled	boilings	boils
starter	starters
injure	injured	injures	injuring
chronic
array	arrayed	arraying	arrays
colonel	colonels
abroad
initiate	initiated	initiates	initiating
discount	discounted	discounting	discounts
poison	poisoned	poisonings	poisons
thanksgiving	thanksgivings
intensity	intensities
basement	basements
jerk	jerked	jerkings	jerks
interact	interacted	interacting	interacts
excess	excesses
illustration	illustrations
abstract	abstracted	abstractest	abstracting	abstracts
essence	essences
container	containers
dynamic	dynamics
gym	gyms
plead	pleaded	pleadings	pleads	pled
promotion	promotions
uncertainty	uncertainties
ownership	ownerships
insult	insulted	insulting	insults
elder	elders
default	defaulted	defaulting	defaults
officially
documentary	documentaries
guilt	guilts
nazi	nazis
orbit	orbited	orbiting	orbits
substitute	substituted	substituter	substitutes	substituting
turkey	turkeys
diagnose	diagnosed	diagnoses	diagnosing
manual	manuals
surge	surged	surges	surging	surgings
fitness	fitnesses
restrict	restricted	restricting	restricts
gulf	gulfs
mommy	mommies
debut	debuted	debuting	debuts
unexpected
kit	kited	kites	kiting	kits
agricultural
spectrum	spectra	spectrums
dragon	dragons
bacteria	bacterias
trillion	trillions
pastor	pastors
chuckle	chuckled	chuckles	chuckling	chucklings
cliff	cliffs
adequate
occupation	occupations
compose	composed	composes	composing
stimulus	stimuli
harsh	harsher	harshest
chaos	chaoses
dot	doted	dotes	doting	dots	dotted	dotting
skirt	skirted	skirting	skirtings	skirts
piano	pianos
surprisingly
lend	lended	lendings	lends	lent
cope
correctly
govern	governed	governessed	governesses	governessing	governing	governs
whip	whipped	whips
modest	modester	modestest
sail	sailed	sailings	sails
psychologist	psychologists
servant	servants
elevator	elevators
extract	extracted	extracting	extracts
transmission	transmissions
parade	paraded	parades	parading
treasure	treasured	treasures	treasuress	treasuring
commonly
cowboy	cowboys
overnight
overseas
mentor	mentored	mentoring	mentorings	mentors
counseling
gentle	gentled	gentler	gentles	gentlest	gentling
rhythm	rhythms
complexity	complexities
nonetheless
loop	looped	loopings	loops
effectiveness	effectivenesses
crawl	crawled	crawlings	crawls
lonely	loneliest	lonelier
statistical
longtime	longtimer
garbage	garbages
devote	devoted	devotees	devotes	devoting
aide
subtle	subtler	subtlest
rod	rods
jam	jammed	jamming	jams
endure	endured	endures	enduring
bitter	bittered	bitterer	bitterest	bittering	bitters
monkey	monkeyed	monkeying	monkeys
basket	baskets
strict	stricter	strictest
loser	losers
saint	sainted	saintess	saintesses	sainting	saints
prosecution	prosecutions
towel	toweled	towelings	towelled	towels
glow	glowed	glowing	glows
chill	chilled	chillings	chills
fluid	fluids
architecture	architectures
romance	romanced	romancer	romances	romancing	romancings
destination	destinations
province	provinces
heal	healed	healings	heals
oral	oraler	orals
genuine
mill	milled	milles	millings	mills
trading
acceptance	acceptances
revelation	revelations
indicator	indicators
span	spaned	spanes	spaning	spanned	spanning	spans
collaboration	collaborations
rhetoric	rhetorics
bust	busted	busting	bustings	busts
inevitable
alongside
protocol	protocols
productive
ranch	ranched	ranches	ranchings
companion	companioned	companioning	companions
dawn	dawned	dawnings	dawns
goodbye	goodbyes
recipient	recipients
luxury	luxuries
practically
persuade	persuaded	persuades	persuading
undermine	undermined	undermines	undermining	underminings
yep
output	outputs	outputted	outputting
underground	undergrounder	undergrounds
medal	medals
endless
translation	translations
conservation	conservations
thrill	thrilled	thrilling	thrills
habitat	habitats
pursuit	pursuits
coordinate	coordinated	coordinates	coordinating
contractor	contractors
backup	backups
trailer	trailers
pitcher	pitchers
outfit	outfits	outfitted
bonus	bonuses
steam	steamed	steaming	steamings	steams
dramatically
audio	audios
genre	genres
caller	callers
exploit	exploited	exploiting	exploits
behavioral
omit	omits	omitted	omitting
puzzle	puzzled	puzzles	puzzling	puzzlings
solo	soli	soloed	soloing	solos
mature	matured	maturer	matures	maturest	maturing
probe	probed	probes	probing	probings
walking
boring
suspend	suspended	suspending	suspends
cholesterol	cholesterols
advertisement	advertisements
bombing
consult	consulted	consulting	consults
expertise	expertises
creator	creators
peaceful
tablet	tablets
equity	equities
rational	rationals
archive	archived	archives	archiving
utilize	utilized	utilizes	utilizing
sneak	sneaked	sneaking	sneaks	snuck
bullshit	bullshits	bullshitted	bullshitting
surgeon	surgeons
affordable
tennis	tennises
artistic
accuracy	accuracies
slope
insert	inserted	inserting	inserts
literacy	literacies
treasury	treasuries
merit	merited	meriting	merits
talented
charter	chartered	chartering	charters
importantly
invisible
sergeant	sergeants
goddamn
regulatory
pad	padded	padding	pads
colony	colonies
supplement	supplemented	supplementing	supplements
accessible
purple	purpled	purpler	purples	purplest	purpling
healing
integration	integrations
cotton	cottoned	cottoning	cottons
spouse	spouses
excitement	excitements
residence	residences
bold	bolder	boldest	bolds
doll	dolls
oxygen	oxygens
prop	propped	propping	props
gravity	gravities
functional
palace	palaces
sole	soled	soler	soles	soling
endorse	endorsed	endorsees	endorses	endorsing
lawmaker	lawmakers
determination	determinations
bully	bullies	bullied	bullying
simultaneously
nasty	nastiest	nastier
administer	administered	administering	administerings	administers
belly	bellies	bellied	bellying	bellyings
rebuild	rebuilded	rebuilding	rebuilds	rebuilt
distract	distracted	distracting	distracts
shy	shies	shied	shyer	shyest	shying
worthy	worthies	worthiest	worthier
statute	statutes
biology	biologies
tuck	tucked	tucking	tucks
plug	plugged	plugging	plugs
follower	followers
forecast	forecasted	forecasting	forecasts
weed	weeded	weeding	weedings	weeds
evident
confess	confessed	confesses	confessing
eligible
isolate	isolated	isolates	isolating
occasional
trunk	trunks
prohibit	prohibited	prohibiting	prohibits
sustainable
gasp	gasped	gasping	gaspings	gasps
banking
asshole	assholes
journalism	journalisms
stumble	stumbled	stumbles	stumbling
obstacle	obstacles
elbow	elbowed	elbowing	elbows
ridge	ridged	ridges	ridging	ridgings
bastard	bastards
apology	apologies
tumor	tumors
architect	architects
dive	dived	dives	divings
wrist	wrists
handsome	handsomer	handsomest
breed	bred	breedings	breeds
realm	realms
blank	blanked	blanker	blankest	blanking	blankings	blanks
inspector	inspectors
surveillance	surveillances
trauma	traumas	traumata
horn	horned	horning	hornings	horns
deadline	deadlines
dip	dipped	dipping	dips
classical
convey	conveyed	conveying	conveys
compensation	compensations
rack	racked	racking	rackings	racks
insect	insects
parliament	parliaments
suite
drum	drummed	drumming	drums
separation	separations
demon	demons
structural
equality	equalities
logical
probability	probabilities
await	awaited	awaiting	awaits
revolutionary	revolutionaries
generous
acquisition	acquisitions
custody	custodies
greet	greeted	greetes	greetings	greets
pulse	pulsed	pulses	pulsing
judicial
earthquake	earthquakes
corrupt	corrupted	corrupter	corruptest	corrupting	corrupts
insane	insaner	insanest
realistic
assemble	assembled	assembles	assembling
necessity	necessities
parameter	parameters
surrender	surrendered	surrendering	surrenders
modify	modifies	modified	modifying
mathematics
nationwide
hallway	hallways
liability	liabilities
sack	sacked	sackings	sacks
theoretical
condemn	condemned	condemning	condemns
con	cones	conned	conning	cons
homeland	homelands
technological
exam	exams
accent	accented	accenting	accents
grill	grilled	grilles	grillings	grills
conscious
vitamin	vitamins
hop	hoped	hopes	hoping	hopped	hopping	hops
hostage	hostages
actively
teenage
retrieve	retrieved	retrieves	retrieving	retrievings
quest	quested	questing	questings	quests
sentiment	sentiments
offering
photography	photographies
laptop	laptops
goodness	goodnesses
affiliation	affiliations
premise	premised	premises	premising
darling	darlings
bee
blessing
curtain	curtained	curtaining	curtains
continuous
landing
jar	jarred	jarring	jars
cage	caged	cages	caging
historically
mud
reminder	reminders
hers
slavery	slaveries
supervisor	supervisors
quantity	quantities
raid	raided	raiding	raids
elaborate	elaborated	elaborates	elaborating
pleasant	pleasanter	pleasantest
caution	cautioned	cautiones	cautioning	cautionings	cautions
faint	fainted	fainter	faintest	fainting	faintings	faints
outlet	outlets
egyptian	egyptians
flour	floured	flouring	flours
declaration	declarations
immune	immunes
calendar	calendared	calendaring	calendars
paragraph	paragraphed	paragraphing	paragraphs
identical
purse	pursed	purses	pursing
entrepreneur	entrepreneurs
specify	specifies	specified	specifying
clay	clays
fist	fists
polish	polished	polishes	polishings
noon	noons
spit	spited	spites	spiting	spits	spitted
outstanding
curl	curled	curlings	curls
unity	unities
manipulate	manipulated	manipulates	manipulating
airplane	airplanes
portfolio	portfolios
mysterious
witch	witched	witches	witchings
delicious	deliciouses
northwest	northwests
profound	profounder	profoundest
nest	nested	nesting	nestings	nests
needle	needled	needles	needless	needling	needlings
lightly
neglect	neglected	neglecting	neglects
colonial	colonials
shove	shoved	shoves	shoving
intimate	intimated	intimater	intimates	intimating
automatic	automatics
exploration	explorations
bush	bushed	busher	bushes	bushings
hack	hacked	hacking	hackings	hacks
fare	fared	fares	faring
limb	limbs
enroll	enrolles	enrolls
southwest	southwests
shrink	shrank	shrinking	shrinks	shrunk	shrunken
arena	arenas
upcoming
forty	forties
someday
unite	united	unites	unitings
steep	steeped	steepest	steeping	steeps
courtesy	courtesies
statue	statues
burning
sometime
peel	peeled	peelings	peels
castle	castled	castles	castling
precise	preciser	precisest
squad	squads
legally
embassy	embassies
patience	patiences
thereby
haul	hauled	hauling	hauls
carpet	carpeted	carpetings	carpets
electrical
charm	charmed	charms
shark	sharked	sharking	sharkings	sharks
halfway
sidewalk	sidewalks
piss	pissed	pisses	pissing
runner	runners
proposition	propositioned	propositioning	propositions
ankle	ankles
attraction	attractions
shuttle	shuttled	shuttles	shuttling
spike	spiked	spikes	spiking
creep	creeped	creeping	creeps	crept
artificial
mercy	mercies
indigenous
cart	carted	cartes	carting	carts
dancer	dancers
candle	candled	candles	candling
glimpse	glimpsed	glimpses	glimpsing
sexually
suburb	suburbs
toxic
alike
sock	socked	socking	socks
sensor	sensors
deploy	deployed	deploying	deploys
railroad	railroaded	railroadings	railroads
magnitude	magnitudes
closing
suspicion	suspicions
icon	icons
grandma	grandmas
info	infos
jurisdiction	jurisdictions
sleeping
mechanical
outdoor
ending
altogether	altogethers
reception	receptions
socialist	socialists
deem	deemed	deeming	deems
whale	whaled	whales	whaling	whalings
credibility	credibilities
aging
loyalty	loyalties
tide	tided	tides	tiding	tidings
traveler	travelers
grief	griefs
metaphor	metaphors
skull	skulls
therapist	therapists
syrian	syrians
workplace	workplaces
instinct	instincts
trim	trimmed	trimmest	trims
bleed	bled	bleedings	bleeds
seventh	sevenths
disclose	disclosed	discloses	disclosing
execution	executions
pal	paled	pales	palings	palled	palling	pals
tender	tendered	tenderer	tenderest	tendering	tenderings	tenders
density	densities
correction	corrections
graph	graphed	graphing	graphs
aboard
underneath
petition	petitioned	petitioning	petitionings	petitions
kinda
relieve	relieved	relieves	relieving
teammate	teammates
corridor	corridors
enthusiasm	enthusiasms
lesbian	lesbians
mild	milder	mildest
productivity	productivities
streak	streaked	streaking	streakings	streaks
minimize	minimized	minimizes	minimizing
amid
inspection	inspections
cab	cabs
nonsense	nonsenses
rider	riders
theology	theologies
terrific
invitation	invitations
laser	lasers
liar	liars
oversee	oversaw	overseed	overseeded	overseeding	overseeds	overseeing	overseen	oversees	overseing
awkward	awkwarder	awkwardest
fork	forked	forking	forks
registration	registrations
suburban
momentum	momenta	momentums
exhaust	exhausted	exhausting	exhausts
instantly
casual
clerk	clerked	clerkess	clerkesses	clerking	clerks
beloved	beloveds
chin	chined	chines	chining	chinned	chinning	chins	chinsed	chinsing
hockey	hockeys
rob	robbed	robbing	robed	robes	robing	robs
ancestor	ancestors
creativity	creativities
verse	versed	verses	versing	versings
cuban	cubans
bail	bailed	bailing	bails
objection	objections
clever	cleverer	cleverest
carbohydrate	carbohydrates
reportedly
sketch	sketched	sketches	sketching
forehead	foreheads
sheep
cloth	cloths
questionnaire	questionnaires
departure	departures
diplomatic
thief
herb	herbs
subsidy	subsidies
halt	halted	halting	haltings	halts
fossil	fossils
mechanic	mechanics
cattle
screening
electoral
supposedly
dignity	dignities
prophet	prophets
commentary	commentaries
delight	delighted	delighting	delights
serving
safely
scar	scares	scaring	scarred	scarring	scars
homework	homeworks
allegedly
android	androids
alpha	alphas
mortality	mortalities
vow	vowed	vowing	vows
neutral	neutrals
contend	contended	contending	contendings	contends
elephant	elephants
solely
continent	continents
ecosystem	ecosystems
syndrome	syndromes
accusation	accusations
pickup	pickups
spite
calculation	calculations
innovative
demographic	demographics
accommodate	accommodated	accommodates	accommodating
jaw	jawed	jawing	jaws
unfair	unfairer	unfairest
tragic
comprise	comprised	comprises	comprising
hunger	hungered	hungering	hungers
nutrition	nutritions
rebound	rebounded	rebounding	rebounds
stance	stances
rabbit	rabbited	rabbiting	rabbits
sip	sipped	sipping	sips
contributor	contributors
cooperate	cooperated	cooperates	cooperating
disk	disked	disking	disks
hesitate	hesitated	hesitates	hesitating
offend	offended	offending	offends
cartoon	cartooned	cartooning	cartoonings	cartoons
compel	compelled	compelling	compels
likelihood	likelihoods
toast	toasted	toastings	toasts
sibling	siblings
southeast	southeasts
gorgeous
undertake	undertaken	undertakes	undertakings	undertook
delegate	delegated	delegatees	delegates	delegating
critique	critiqued	critiques	critiquing
painter	painters
residential
counterpart	counterparts
believer	believers
lamp	lamps
inmate	inmates
thoroughly
triple	tripled	tripler	triples	triplings
pillow	pillowed	pillowing	pillows
likewise
cease	ceased	ceases	ceasing	ceasings
interface	interfaces
cough	coughed	coughings	coughs
fleet	fleeted	fleeter	fleetest	fleeting	fleetings	fleets
drone	droned	drones	droning
vanish	vanished	vanishes	vanishings
instructional
clause	clauses
mentally
pond	ponds
popularity	popularities
transit	transited	transiting	transits
authorize	authorized	authorizes	authorizing
tattoo	tattooed	tattooing	tattoos
fever	fevers
pirate	pirated	pirates	piratess	pirating
pat	pates	pats	patted	patting
traditionally
vendor	vendors
poorly
arrow	arrows
meantime	meantimes
sculpture	sculptured	sculptures	sculpturing	sculpturings
blink	blinked	blinking	blinkses
conceive	conceived	conceives	conceiving