opt	opted	opting	opts
descend	descended	descending	descendings	descends
bolt	bolted	bolting	boltings	bolts
firmly
bark	barked	barking	barks
openly
bargain	bargained	bargaining	bargains
shallow	shallowed	shallower	shallowest	shallowing	shallowings	shallows
gathering
preach	preached	preaches	preachings
interfere	interfered	interferes	interfering
inventory	inventories	inventorying
pioneer	pioneered	pioneering	pioneers
scatter	scattered	scatterings	scatters
capitalism	capitalisms
presumably
soap	soaped	soaping	soaps
illusion	illusions
removal	removals
anxious
organism	organisms
addict	addicted	addicting	addicts
dock	docked	dockings	docks
harassment	harassments
diminish	diminished	diminishes	diminishing	diminishings
helmet	helmets
certificate	certificated	certificates	certificating
tribal
canvas	canvased	canvases	canvasing
auction	auctioned	auctioning	auctions
stab	stabbed	stabbing	stabs
rubber	rubbered	rubberer	rubbering	rubbers
sadly
sunlight	sunlights
discharge	discharged	dischargees	discharges	discharging
delete	deleted	deletes	deleting
rookie	rookies
clarify	clarifies	clarified	clarifying
practitioner	practitioners
performer	performers
protective
programming
virgin	virgins
salmon	salmons
census	censused	censuses	censusing
hybrid	hybrids
accomplishment	accomplishments
bicycle	bicycled	bicycles	bicycling
conscience	consciences
fortunately
minimal
molecule	molecules
supportive
spoon	spooned	spooning	spoons
threshold	thresholds
comply	complies	complied	complying
monetary
influential
verbal
bass	basser	basses	bassest
ranking
gram	grams
envelope
rolling
toll	tolled	tolling	tollings	tolls
classify	classifies	classifying
hostile	hostiles
enact	enacted	enacting	enacts
unfortunate	unfortunates
readily
roar	roared	roarings	roars
addiction	addictions
marker	markers
juror	jurors
lease	leased	leases	leasing	leasings
businessman
retailer	retailers
liver	livers
australian	australians
prep	preps
protester	protesters
outlook	outlooks
gallon	gallons
additionally
ignorance	ignorances
chemistry	chemistries
babe	babes
fraction	fractioned	fractioning	fractions
conversion	conversions
tolerate	tolerated	tolerates	tolerating
drown	drowned	drowning	drownings	drowns
balloon	ballooned	balloonings	balloons
citizenship	citizenships
coordinator	coordinators
validity	validities
swell	swelled	sweller	swellest	swellings	swells	swollen
lightning	lightnings
turtle	turtled	turtles	turtling	turtlings
ambition	ambitioned	ambitioning	ambitions
delicate
overhead	overheads
instruct	instructed	instructing	instructs
shortage	shortages
useless
booth	booths
diary	diaries
suspicious
frown	frowned	frowning	frowns
excite	excited	excites	exciting
publishing
curiosity	curiosities
grid	grids
riot	rioted	riotings	riots
cruel	crueler	cruelest
disclosure	disclosures
cue	cued	cueing	cues	cuing
denial	denials
secular	seculars
speculation	speculations
sympathy	sympathies
inappropriate
partial	partials
sodium	sodiums
sheer	sheered	sheerer	sheerest	sheering	sheers
broker	brokered	brokeress	brokering	brokerings	brokers
obscure	obscured	obscurer	obscures	obscurest	obscuring
barn	barns
reliability	reliabilities
slot	sloted	slots	slotted	slotting
hormone	hormones
footage	footages
carve	carved	carves	carvings
articulate	articulated	articulates	articulating
alley	alleys
stiff	stiffer	stiffest	stiffs
coastal
cafe	cafes
flexible
talking
snack	snacked	snacking	snacks
afghan	afghans
vampire	vampires
optimistic
dessert	desserts
northeast	northeasts
dutch	dutches	dutchess
specialize	specialized	specializes	specializing
availability	availabilities
compliance	compliances
pork	porks
astronomer	astronomers
remedy	remedies	remedying
revenge	revenged	revenges	revenging	revengings
forbid	forbade	forbad	forbidden	forbids
installation	installations
plague	plagued	plagues	plaguing
exclusively
goat	goats
equip	equiped	equipes	equipped	equipping	equips
betray	betrayed	betraying	betrays
willingness	willingnesses
banker	bankers
interval	intervals
gasoline	gasolines
bucket	bucketed	bucketing	bucketings	buckets
rap	raped	rapes	raping	rapped	rapping	raps
heck
clutch	clutched	clutches	clutching
theft	thefts
laundry	laundries
constraint	constraints
hatred	hatreds
jewelry	jewelries
migration	migrations
lure	lured	lures	luring
invention	inventions
poke	poked	pokes	poking
bulk	bulked	bulking	bulkings	bulks
doom	doomed	dooming	dooms
unprecedented
halloween	halloweens
chunk	chunked	chunkings	chunks
sweetheart	sweethearts
lazy	laziest	lazier
defender	defenders
atheist	atheists
stall	stalled	stallings	stalls
technically
manufacture	manufactured	manufactures	manufacturess	manufacturings
peanut	peanuts
unclear	unclearer	unclearest
workout	workouts
wilderness	wildernesses
eleven	elevener	elevens	elevenses
backyard	backyards
partially
guardian	guardians
passionate
scripture	scriptures
spectacular	spectaculars
dictate	dictated	dictates	dictating
midst	midsts
ideological
breeze	breezed	breezes	breezing
thrive	thrived	thriven	thrives	thriving	thrivings	throve
sensitivity	sensitivities
strap	strapped	strapping	straps
emotionally
ignorant
junk	junked	junking	junks
explicitly
unfold	unfolded	unfoldings	unfolds
headache	headaches
eternal
smash	smashed	smashes	smashings
tropical
ego	egos
verdict	verdicts
accountability	accountabilities
nominate	nominated	nominates	nominating
civic
brake	braked	brakes	braking
uncover	uncovered	uncovering	uncovers
groan	groaned	groaning	groanings	groans
aisle	aisles
triumph	triumphed	triumphing	triumphings	triumphs
breathing
annually
eighth	eighths
cooperative	cooperatives
compassion	compassions
whistle	whistled	whistles	whistlings
lodge	lodged	lodges	lodgings
downstairs
verify	verifies	verified	verifying
affiliate	affiliated	affiliates	affiliating
offender	offenders
inherit	inherited	inheriting	inherits
choke	choked	chokes	choking
strive	strived	striven	strives	strivings	strove
bore	bored	borees	bores	borings
appreciation	appreciations
chew	chewed	chewing	chews
magical
loyal	loyaler	loyalest
scent	scented	scenting	scentings	scents
desperately
throne	throned	thrones	throning
brutal
pardon	pardoned	pardoning	pardonings	pardons
propaganda	propagandas
irony	ironies
soda	sodas
projection	projections
speaking
spur	spurred	spurs
parental
collector	collectors
accounting
disappointment	disappointments
afterward
correlate	correlated	correlates	correlating
happily
pipeline	pipelines
listener	listeners
stain	stained	stainings	stains
drawer	drawers
developmental
ash	ashed	ashes	ashing
socially
tick	ticked	tickings	ticks
courtroom	courtrooms
trainer	trainers
induce	induced	induces	inducing
anytime
morality	moralities
partisan	partisans
bride	brides
doorway	doorways
learner	learners
casino	casinos
placement	placements
cord	corded	cording	cordings	cords
conception	conceptions
flexibility	flexibilities
thou	thous
noble	nobler	nobles	noblest
elegant	eleganter
distress	distressed	distresses	distressing
flaw	flawed	flawing	flaws
locker	lockers
stride	stridden	strides	striding	strode
plea	pleas
amateur	amateurs
boast	boasted	boastings	boasts
alternate	alternated	alternater	alternates	alternating
gosh
philosophical
vocal	vocals
destiny	destinies
ambitious
unbelievable
jealous
sphere	spheres
invade	invaded	invades	invading
dancing
excessive
countless
flush	flushed	flusher	flushes	flushest	flushing	flushings
sunset	sunsets
dam	dames	dammed	damming	dams
dash	dashed	dashes	dashing
plunge	plunged	plunges	plunging	plungings
faithful	faithfuls
vertical	verticals
freely
adaptation	adaptations
ray	rays
emperor	emperors
wagon	wagons
columnist	columnists
jungle	jungles
terminal	terminals
mushroom	mushroomed	mushrooming	mushrooms
homosexual	homosexuals
venue	venues
discourage	discouraged	discourages	discouraging	discouragings
isolation	isolations
explicit
commodity	commodities
attendance	attendances
tab	tabs
utter	uttered	utterest	uttering	utterings	utters
consequently
vacuum	vacua	vacuumed	vacuuming	vacuums
dough	doughs
manifest	manifested	manifester	manifesting	manifests
silk	silks
mold	molded	moldings	molds
similarity	similarities
steak	steaks
haunt	haunted	haunting	hauntings	haunts
viable
dial	dialed	dialing	dialings	dials
monument	monuments
collar	collared	collaring	collars
sleeve	sleeves
fry	fries	fried	frying
stereotype	stereotyped	stereotypes	stereotyping	stereotypings
reluctant
softly
steer	steered	steerings	steers
graduation	graduations
deliberately
consecutive
accurately
strictly
casualty	casualties
risky	riskiest	riskier
banana	bananas
beneficial
rude	ruder	rudest
usage	usages
testament	testaments
browser	browsers
processor	processors
thigh	thighs
holding
merchant	merchants
preliminary	preliminaries
quantum	quanta
mighty	mightiest	mightier
eyebrow	eyebrows
vocabulary	vocabularies
ashamed
radar	radars
murderer	murderers
recount	recounted	recounting	recounts
burger	burgers
align	aligned	aligning	aligns
textbook	textbooks
sensation	sensations
fragment	fragmented	fragmenting	fragments
sunny	sunniest	sunnier
antique	antiqued	antiquer	antiques	antiquing
keyboard	keyboards
persist	persisted	persisting	persists
wheat	wheats
predator	predators
bizarre
homicide	homicides
withdrawal	withdrawals
straw	strawed	strawer	strawing	straws
canal	canaled	canales	canaling	canals
foul	fouled	fouler	foulest	fouling	foulings	fouls
feather	feathered	featherings	feathers
legislator	legislators
humble	humbled	humbler	humbles	humbleses	humblesses	humblest	humbling	humblings
uncertain
ladder	laddered	laddering	ladders
tolerance	tolerances
mineral	minerals
wallet	wallets
parish	parishes
federation	federations
interactive
epic	epics
unnecessary
confession	confessions
proclaim	proclaimed	proclaiming	proclaims
duration	durations
salvation	salvations
rental	rentaler	rentals
beard	bearded	bearding	beards
excerpt	excerpted	excerpting	excerptings	excerpts
mob	mobbed	mobbing	mobs
suitable
disturb	disturbed	disturbing	disturbs
comparable
pencil	penciled	penciling	pencilings	pencilled	pencilling	pencils
rib	ribbed	ribbing	ribs
unhappy	unhappiest	unhappier
hail	hailed	hailes	hailing	hails
marketplace	marketplaces
reasoning
rim	rimed	rimes	riming	rimmed	rimming	rims
supporting
orchestra	orchestras
manuscript	manuscripts
advocacy	advocacies
purely
empirical
assertion	assertions
outbreak	outbreaks
costly	costliest	costlier
seller	sellers
tilt	tilted	tilting	tiltings	tilts
audit	audited	auditing	audits
waist	waists
irrelevant
aesthetic	aesthetics
weaken	weakened	weakening	weakens
wireless	wirelesses
saying
suspension	suspensions
prosecute	prosecuted	prosecutes	prosecuting
undergraduate	undergraduates
notebook	notebooks
cocktail	cocktails
memo	memos
tense	tensed	tenser	tenses	tensest	tensing
drought	droughts
eve	eves
juvenile	juveniles
authentic
vet	vets	vetted	vetting
tightly
organizational
hazard	hazarded	hazarding	hazards
regulator	regulators
yankee	yankees
dilemma	dilemmas
afterwards
scramble	scrambled	scrambles	scrambling	scramblings
philosopher	philosophers
sexuality	sexualities
taxi	taxied	taxies	taxiing	taxis	taxying
librarian	librarians
unto
concede	conceded	concedes	conceding
zoo	zoos
notify	notifies	notified	notifying
don	donned	donning	dons
fatal
baseline	baselines
tracking
saudi	saudis
shareholder	shareholders
logo	logos
grind	grinded	grindings	grinds
symbolic
chick	chicks
algorithm	algorithms
texture	textures
biblical
seeing
herd	herded	herdess	herdesses	herding	herds
rig	rigged	rigging	rigs
dull	dulled	duller	dullest	dulling	dulls
reasonably
allege	alleged	alleges	alleging
widow	widowed	widowing	widows
cling	clinged	clinging	clings	clung
artifact	artifacts
confine	confined	confines	confining
charming	charminger	charmingest
magnetic
confirmation	confirmations
weave	weaved	weaves	weavings	wove	woven
automobile	automobiled	automobiles	automobiling
slate
firearm	firearms
making
blogger	bloggers
utterly
exotic
median	medians
ill	ills
completion	completions
militant	militants
epidemic	epidemics
advisor	advisors
regression	regressions
stern	sterner	sternest	sterns
accord	accorded	according	accords
activate	activated	activates	activating
complication	complications
terribly
wreck	wrecked	wreckings	wrecks
surf	surfed	surfings	surfs
sharply
plaintiff	plaintiffs
lineup	lineups
worm	wormed	worming	worms
breach	breached	breaches	breaching
neat	neater	neatest
dice	diced	dices	dicing	dicings
fairy	fairies
suppress	suppressed	suppresses	suppressing
substantially
variance	variances
notable	notables
holder	holders
convenient
insider	insiders
hopeful	hopefuls
refrigerator	refrigerators
inevitably
frustrate	frustrated	frustrates	frustrating
grandparent	grandparents
applicant	applicants
scrap	scraped	scrapes	scrapings	scrapped	scrapping	scraps
mock	mocked	mocking	mockings	mocks
shooter	shooters
thrust	thrusted	thrustings	thrusts
vague	vaguer	vaguest
accountable
greenhouse	greenhouses
outsider	outsiders
lighting
impulse	impulses
endeavor	endeavored	endeavoring	endeavors
papa	papas
crude	cruder	crudes	crudest
skeptical
subsequently
marvel	marveled	marveling	marvelled	marvelling	marvels
grandchild	grandchildren
escort	escorted	escorting	escorts
inability	inabilities
ecological
intact
correspond	corresponded	corresponding	corresponds
inclusion	inclusions
kidney	kidneys
knot	knots	knotted	knotting
cocaine	cocaines
prejudice	prejudiced	prejudices	prejudicing
evangelical
entertain	entertained	entertaining	entertainings	entertains
thoughtful
inn	inns
miserable
winning	winnings
latino	latinos
systematic
fierce	fiercer	fiercest
dislike	disliked	dislikes	disliking
statistically
supplier	suppliers
fabulous
homeowner	homeowners
patron	patrons
soak	soaked	soakings	soaks
warehouse	warehoused	warehouses	warehousings
inherent
cult	cults
setup	setups
decorate	decorated	decorates	decorating
reactor	reactors
nope
absurd	absurder	absurdest	absurds
cemetery	cemeteries
carrot	carrots
modification	modifications
shrimp	shrimped	shrimping	shrimpings	shrimps
hedge	hedged	hedges	hedgings
congratulation	congratulations
dissolve	dissolved	dissolves	dissolvings
infect	infected	infecting	infects
absent	absented	absenter	absenting	absents
warfare	warfares
simulation	simulations
debris
speculate	speculated	speculates	speculating
aggression	aggressions
clash	clashed	clashes	clashing	clashings
dim	dimes	dimmed	dimmest	dimming	dims
organizer	organizers
depart	departed	departing	departings	departs
evolutionary
reside	resided	resides	residing
sweater	sweaters
sprinkle	sprinkled	sprinkles	sprinklings
metropolitan	metropolitans
hawk	hawked	hawkings	hawks
envision	envisioned	envisioning	envisions
transmit	transmits	transmitted	transmitting
namely
leverage	leveraged	leverages	leveraging
stimulate	stimulated	stimulates	stimulating
consistency	consistencies
migrant	migrants
spotlight	spotlighted	spotlighting	spotlights	spotlit
accelerate	accelerated	accelerates	accelerating
skilled
convenience	conveniences
provoke	provoked	provokes	provoking
roast	roasted	roastings	roasts
lick	licked	lickings	licks
swimming	swimmings
tribute	tributes
paradise	paradises
antibiotic	antibiotics
acute	acuter	acutes	acutest
formerly
slim	slimed	slimer	slimes	sliming	slimmer	slimmest	slims
waiting
flu
cargo	cargoes	cargos
harmony	harmonies
rotation	rotations
frontier	frontiers
transplant	transplanted	transplantings	transplants
mandatory	mandatories
frog	frogged	frogging	frogs
slaughter	slaughtered	slaughtering	slaughterings	slaughters
backward
atom	atoms
severely
prey	preyed	preying	preys
subscribe	subscribed	subscribes	subscribing	subscribings
scrutiny	scrutinies
upward
polite	politer	politest
curb	curbed	curbings	curbs
tenure	tenured	tenures	tenuring
pasta	pastas
publicity	publicities
colorful
spiral	spiraled	spiraling	spiralled	spiralling	spirals
voluntary	voluntaries
repeal	repealed	repealing	repeals
applause	applauses
spine
advisory	advisories
tile	tiled	tiles	tilings
overwhelm	overwhelmed	overwhelming	overwhelmings	overwhelms
prosperity	prosperities
glare	glared	glares	glaring
striking
mansion	mansions
compile	compiled	compiles	compiling
ninth	ninths
pathway	pathways
foolish	foolisher	foolishest
strand	stranded	stranding	strands
fortunate
zombie	zombies
inaudible
coincidence	coincidences
desktop	desktops
whatsoever
expenditure	expenditures
rejection	rejections
clarity	clarities
militia	militias
glue	glued	glueing	glues	gluing
legendary
deed	deeds
sweetie	sweeties
accordingly
pumpkin	pumpkins
pronounce	pronounced	pronounces	pronouncing	pronouncings
municipal
navigate	navigated	navigates	navigating
ward	warded	warding	wardings	wards
blond	blonder	blondest	blonds
vein	veined	veining	veinings	veins
skinny	skinnies	skinniest	skinnier
coup	coups
tray	trays
visa	visaed	visaing	visas
robbery	robberies
prevail	prevailed	prevailing	prevails
tighten	tightened	tightenings	tightens
obesity	obesities
informal
clown	clowned	clownings	clowns
ink	inked	inking	inks
aluminum	aluminums
disagreement	disagreements
positively
contemplate	contemplated	contemplates	contemplating
pistol	pistols
methodology	methodologies
breakdown	breakdowns
regain	regained	regaining	regains
uphold	upheld	upholding	upholdings	upholds
routinely
stove	stoves
ambulance	ambulances
specialty	specialties
serial	serials
bulb	bulbs
protestant	protestants
problematic
paradigm	paradigms
driveway	driveways
persian	persians
accommodation	accommodations
bundle	bundled	bundles	bundlings
grove	groves
catalog	cataloged	cataloging	catalogs
landmark	landmarks
prescribe	prescribed	prescribes	prescribing
reconstruction	reconstructions
reign	reigned	reigning	reigns
respective
linear
notably
arch	arched	arches	archest	arching	archings
sailor	sailors
pathetic
matrix	matrices	matrixes
bout	bouts
confrontation	confrontations
financially
flock	flocked	flocking	flockings	flocks
classification	classifications
tease	teased	teases	teasings
rattle	rattled	rattles	rattlings
disc	discs
urgent
semester	semesters
plaza	plazas
sway	swayed	swaying	swayings	sways
congregation	congregations
bound	bounded	bounding	bounds
rising
theirs
disrupt	disrupted	disrupting	disrupts
considerably
fog	fogged	fogging	fogs
autism	autisms
console	consoled	consoles	consoling
password	passwords
hollow	hollowed	hollower	hollowest	hollowing	hollows
spice	spiced	spices	spicing
theological
nutrient	nutrients
thunder	thundered	thundering	thunderings	thunders
warmth	warmths
fur	furs
roster	rosters
affection	affections
chorus	chorused	choruses	chorusing	chorussed	chorusses	chorussing
memoir	memoirs
shiny	shiniest	shinier
obey	obeyed	obeying	obeys
endorsement	endorsements
naval
bloom	bloomed	blooming	blooms
compact	compacted	compacter	compactest	compacting	compacts
butterfly	butterflies	butterflying
crisp	crisped	crisper	crispest	crisping	crisps
scrape
electronics
diagram	diagramed	diagraming	diagrammed	diagramming	diagrams
compensate	compensated	compensates	compensating
lid	lids
hood	hooded	hooding	hoods
scoop	scooped	scooping	scoopings	scoops
distraction	distractions
justification	justifications
subway	subways
fox	foxed	foxes	foxing
sour	soured	sourer	sourest	sourings	sours	sourses
forge	forged	forges	forgings
skate	skated	skates	skatings
atop
nickname	nicknamed	nicknames	nicknaming
wizard	wizards
compliment	complimented	complimenting	compliments
fracture	fractured	fractures	fracturing
grunt	grunted	grunting	gruntings	grunts
shave	shaved	shaven	shaves	shavings
fragile	fragiler	fragilest
despair	despaired	despairing	despairs
stalk	stalked	stalkings	stalks
autonomy	autonomies
massage	massaged	massages	massaging
originate	originated	originates	originating
newsletter	newsletters
wheelchair	wheelchairs
batter	battered	batterings	batters
mathematical
biography	biographies
invoke	invoked	invokes	invoking
oversight	oversights
privately
dick	dicks
puppy	puppies
splash	splashed	splashes	splashings	splashs
fatigue	fatigued	fatigues	fatiguing
dense	denser	densest
trophy	trophies
pity	pities	pitied	pitying
spider	spiders
economically
intervene	intervened	intervenes	intervening
fisherman	fishermen
planner	planners
coaching
fulfil	fulfilled	fulfilling	fulfils
inequality	inequalities
workforce	workforces
terrain	terrains
trader	traders
mormon	mormons
selfish
implant	implanted	implanting	implants
sovereignty	sovereignties
hover	hovered	hovering	hovers
farming
interstate	interstates
temper	tempered	temperings	tempers
fundamentally
libertarian	libertarians
banner	bannerer	banners
grape	grapes
refuge	refuges
restoration	restorations
expedition	expeditions
straighten	straightened	straightening	straightens
imperial	imperials
transcript	transcripts
payroll	payrolls
navigation	navigations
accumulate	accumulated	accumulates	accumulating
summarize	summarized	summarizes	summarizing
listening
drip	dripped	drips
favorable
advertise	advertised	advertises	advertisings
analogy	analogies
terrify	terrifies	terrified	terrifying
dinosaur	dinosaurs
robust	robuster	robustest
geographic
marathon	marathons
erase	erased	erases	erasing
diplomat	diplomats
geography	geographies
mister	misters
embody	embodies	embodied	embodying
incumbent	incumbents
lounge	lounged	lounges	lounging	loungings
nationally
molecular
fax	faxed	faxes	faxing
furious	furiouser
folder	folders
subjective
persistent
maximize	maximized	maximizes	maximizing
feast	feasted	feastings	feasts
ironically
champagne	champagnes
affirmative	affirmatives
chant	chanted	chantings	chants
generator	generators
brace	braced	braces	bracings
corpse
tourism	tourisms
firefighter	firefighters
troll	trolled	trollings	trolls
builder	builders
pinch	pinched	pinches	pinching	pinchings
nicely
founding
designate	designated	designates	designating
copper	coppered	coppering	copperings	coppers
ditch	ditched	ditches	ditching
stink	stank	stinking	stinkings	stinks	stunk
temporarily
penny	pennies	pence
intensive	intensives
immunity	immunities
sofa	sofas
thesis	theses
fulfill	fulfillings	fulfills
independently
ruler	rulers
thy
mutter	muttered	mutterings	mutters
ribbon	ribbons
basin	basins
capitalist	capitalists
kneel	kneeled	kneeling	kneels	knelt
abundance	abundances
baking
mobility	mobilities
specimen	specimens
enrollment	enrollments
bomber	bombers
reproduce	reproduced	reproduces	reproducing
credible
spatial
profitable
humanitarian	humanitarians
honesty	honesties
lone
happening
deliberate	deliberated	deliberates	deliberating
sprint	sprinted	sprinting	sprintings	sprints
dolphin	dolphins
tug	tugged	tugging	tugs
defect	defected	defecting	defects
autumn	autumns
transparent
outrage	outraged	outrages	outraging
pharmaceutical	pharmaceuticals
attain	attained	attaining	attains
sob	sobbed	sobbing	sobs
coke	coked	cokes	cokeses	coking
arctic	arctics
impairment	impairments
brass	brasses
wedge	wedged	wedges	wedging	wedgings
certainty	certainties
supermarket	supermarkets
filmmaker	filmmakers
gambling
sniff	sniffed	sniffing	sniffings	sniffs
distinctive
commentator	commentators
classmate	classmates
hydrogen	hydrogens
videotape	videotaped	videotapes	videotaping
entitlement	entitlements
passive	passives
harmful
millennium	millennia	millenniums
blur	blurred	blurring	blurs
vintage	vintages
continually
explorer	explorers
motel	motels
oath	oaths
amongst
missionary	missionaries
medieval
ironic
separately
facial	facials
governance	governances
merry	merriest	merrier
comprehension	comprehensions
lobbyist	lobbyists
predecessor	predecessors
precedent	precedents
conceal	concealed	concealing	conceals
embed	embedded	embedding	embeds
shotgun	shotguns
condom	condoms
extremist	extremists
appetite	appetites
dome	domes
presume	presumed	presumes	presuming
hum	hummed	humming	hums
stun	stunned	stunning	stuns
prevalence	prevalences
exile	exiled	exiles	exiling
punk	punker	punkest	punks
hierarchy	hierarchies
foreigner	foreigners
rainbow	rainbows
badge	badged	badges	badging
assassination	assassinations