inadequate
detection	detections
closure	closured	closures	closuring
surplus	surpluses
electron	electrons
static	statics
policeman	policemen
explosive	explosives
bachelor	bachelors
announcer	announcers
kidnap	kidnaped	kidnaping	kidnapped	kidnaps
empower	empowered	empowering	empowers
unemployed	unemployeds
rehabilitation	rehabilitations
merge	merged	mergees	merges	mergings
tuition	tuitions
subscription	subscriptions
mosque	mosques
kilometer	kilometers
exceptional
rug	rugs
preservation	preservations
aftermath	aftermaths
mankind	mankinds
intersection	intersections
module	modules
permanently
passport	passports
litigation	litigations
unconscious	unconsciouses
hometown	hometowns
attendant	attendants
cement	cemented	cementing	cements
fountain	fountains
surgical
steadily
backwards
motherfucker	motherfuckers
premier	premiered	premieres	premieress	premiering	premiers
manipulation	manipulations
reverend	reverends
premiere
concession	concessions
veto	vetoed	vetoes	vetoing
sore	sorer	sores	sorest
injection	injections
marble	marbled	marbles	marblings
seminar	seminars
expire	expired	expires	expiring
gauge	gauged	gauges	gauging	gaugings
offset	offsets	offsetting
akin
circulation	circulations
lump	lumped	lumping	lumps
renew	renewed	renewing	renewings	renews
inject	injected	injecting	injects
breakthrough	breakthroughs
cottage	cottages
loom	loomed	looming	looms
nap	napes	napped	napping	naps
euro	euros
zip	zipped	zipping	zips
dispatch	dispatched	dispatches	dispatching
prospective
innocence	innocences
lender	lenders
mug	mugged	mugs
slash	slashed	slashes	slashing	slashings
soar	soared	soares	soarings	soars
tub	tubs
void	voided	voidings	voids
robe
rotate	rotated	rotates	rotating
cutting	cuttings
eclipse	eclipsed	eclipses	eclipsing
tricky	trickiest	trickier
listing
pending
blonde	blondes
obsession	obsessions
unlimited
sting	stinged	stingings	stings	stung
ballet	ballets
coefficient	coefficients
tenant	tenanted	tenanting	tenants
atomic
liberation	liberations
giggle	giggled	giggles	giggling	gigglings
claw	clawed	clawing	claws
ant	ants
swamp	swamped	swamping	swamps
smack	smacked	smackings	smacks
vulnerability	vulnerabilities
maneuver	maneuvered	maneuvering	maneuverings	maneuvers
pea	peas	pease
dairy	dairies
gossip	gossiped	gossipings	gossips
vinegar	vinegars
destructive
cube
detention	detentions
silicon	silicons
tan	tanned	tannest	tanning	tans
unlock	unlocked	unlocking	unlocks
ethnicity	ethnicities
inspect	inspected	inspecting	inspects
crab	crabbed	crabbing	crabs
gum	gummed	gumming	gums
wit	wits
adjacent
genuinely
swap	swapped	swapping	swaps	swopped	swopping	swops
interference	interferences
disguise	disguised	disguises	disguising	disguisings
competence	competences
stroll	strolled	strolling	strollings	strolls
imagery	imageries
affirm	affirmed	affirming	affirms
preview	previewed	previewing	previews
sovereign	sovereigns
whine	whined	whines	whining	whinings
dating
ramp	ramped	ramping	rampings	ramps
soften	softened	softenings	softens
attachment	attachments
villain	villains
ensemble	ensembles
grandpa	grandpas
twilight	twilights
sympathetic
indictment	indictments
consultation	consultations
bronze	bronzed	bronzer	bronzes	bronzing	bronzings
physicist	physicists
tempt	tempted	tempting	temptings	tempts
collaborative
triangle	triangles
jack	jacked	jacking	jacks
infinite	infinites
lace	laced	laces	lacings
gig	gigs
precision	precisions
revise	revised	revises	revising
hut	huts
petty	petties	pettiest	pettier
locally
excellence	excellences
rabbi	rabbis
bait	baited	baitings	baits
sophomore	sophomores
overly
turnover	turnovers
incidence	incidences
negro	negroes	negros
holly	hollies
realization	realizations
flourish	flourished	flourishes	flourishing
receipt	receipted	receipting	receipts
waiter	waiters
flick	flicked	flicking	flicks
desirable
bipartisan
sadness	sadnesses
devise	devised	devisees	devises	devisings
sixteen	sixteener	sixteens
predictable
remarkably
yoga	yogas
massacre	massacred	massacres	massacring
cohort	cohorts
gown	gowned	gowning	gowns
dwarf	dwarfed	dwarfing	dwarfs	dwarves
arc	arced	arcing	arcked	arcking	arcs
psychiatrist	psychiatrists
roommate	roommates
hobby	hobbies
competent
admiral	admirals
discard	discarded	discarding	discards
maid	maids
murmur	murmured	murmurings	murmurs
portable	portables
gee	geed	geeing	gees
symphony	symphonies
injustice	injustices
albeit
primitive	primitives
par	pared	pares	parings	pars
trustee	trustees
evoke	evoked	evokes	evoking
reel	reeled	reeling	reelings	reels
revive	revived	revives	reviving	revivings
comet	comets
lamb	lambed	lambes	lambing	lambs
forgiveness	forgivenesses
nationalist	nationalists
bacon	bacons
cherry	cherries
contradiction	contradictions
shaft	shafted	shafting	shaftings	shafts
heroin	heroins
continental
genome	genomes
lifelong
undoubtedly
backpack	backpacked	backpackings	backpacks
generic	generics
viewpoint	viewpoints
mining
rehearsal	rehearsals
spoil	spoiled	spoiling	spoils	spoilt
sideline	sidelined	sidelines	sidelining
axis	axises
summon	summoned	summonings
heap	heaped	heaping	heaps
peasant	peasants
thorough	thorougher	thoroughest
constituent	constituents
hatch	hatched	hatches	hatchings
technician	technicians
accessory	accessories
magnificent
choir	choired	choiring	choirs
misery	miseries
trout	trouts
intake	intakes
incorrect
niche	niches
biologist	biologists
merger	mergers
vanilla	vanillas
hebrew	hebrews
yank	yanked	yanking	yanks
dual
nephew	nephews
dioxide	dioxides
conceptual
memorable
descent	descents
weep	weeped	weepings	weeps	wept
arguably
twentieth	twentieths
handy	handiest	handier
peach	peached	peaches	peaching
liquor	liquors
communism	communisms
superintendent	superintendents
node
motorcycle	motorcycled	motorcycles	motorcycling
posture	postured	postures	posturings
revision	revisions
bud	budded	buds
creepy	creepiest	creepier
ugh
enlist	enlisted	enlisting	enlists
glorious
successor	successors
thee
predictor	predictors
circus	circuses
accidentally
preacher	preachers
reproductive
baptist	baptists
cinema	cinemas
tremble	trembled	trembles	tremblings
blah	blahs
felony	felonies
melody	melodies
underwear	underwears
hostility	hostilities
documentation	documentations
dusty	dustiest	dustier
colored
elevate	elevateds	elevates	elevating
turning
precede	preceded	precedes	preceding
defy	defies	defied	defying
pupil	pupils
printer	printers
scrub	scrubbed	scrubs
swirl	swirled	swirling	swirls
seldom
formally
cleaning
ache	ached	aches	achings
outright
viking	vikings
cultivate	cultivated	cultivates	cultivating
subscriber	subscribers
spokeswoman	spokeswomen
cautious
transparency	transparencies
psychiatric
eighteen	eighteens
greed	greeds
beta	betas
madness	madnesses
aspiration	aspirations
handling
operational
certification	certifications
diameter	diameters
armor	armored	armoring	armors
translator	translators
filing
crust	crusted	crusting	crusts
naive	naiver	naivest
idol	idols
orthodox
sufficiently
insurer	insurers
erupt	erupted	erupting	erupts
thankful
perch	perched	perches	perching	perchings
nurture	nurtured	nurtures	nurturing
paperwork	paperworks
collision	collisions
goose	geese	goosed	gooses	goosing
cane
messenger	messengers
tumble	tumbled	tumbles	tumblings
circulate	circulated	circulates	circulating	circulatings
saddle	saddled	saddles	saddling
optimism	optimisms
illuminate	illuminated	illuminates	illuminating
blaze	blazed	blazes	blazing
sunshine	sunshines
collaborate	collaborated	collaborates	collaborating
composer	composers
salon	salons
replicate	replicated	replicates	replicating
impeachment	impeachments
envy	envies	envied	envying	envyings
flap	flapped	flaps
silently
bureaucracy	bureaucracies
applaud	applauded	applauding	applauds
cosmic
toddler	toddlers
litter	littered	littering	litters
beautifully
vest	vested	vesting	vestings	vests
individually
renaissance	renaissances
fairness	fairnesses
morally
peek	peeked	peeking	peeks
encompass	encompassed	encompasses	encompassing
unaware
sanctuary	sanctuaries
slack	slacked	slackest	slacking	slacks
timber	timbers
suitcase	suitcases
monopoly	monopolies
resignation	resignations
sensible	sensibler	sensiblest
wildly
paste	pasted	pastes	pasting	pastings
ho	hos
fishery	fisheries
google	googled	googles	googling
supper	suppers
awaken	awakened	awakenings	awakens
applicable
mat	mated	mates	mating	mats	matted
fourteen	fourteener	fourteens
mentality	mentalities
bead	beaded	beadings	beads
faction	factions
cellular
artwork	artworks
microphone	microphones
gamble	gambled	gambles	gamblings
restraint	restraints
shatter	shattered	shattering	shatters
meditation	meditations
underestimate	underestimated	underestimates	underestimating
picnic	picnicked	picnicking	picnics
pesticide	pesticides
socialism	socialisms
relay	relayed	relaying	relays
tin	tines	tinned	tinning	tins
instrumental
diner	diners
fella	fellas
vent	vented	ventings	vents
judiciary	judiciaries
wicked	wickeder	wickedest
puppet	puppets
ferry	ferries	ferried	ferrying
dart	darted	darting	darts
hub	hubs
astronaut	astronauts
mound	mounded	mounding	mounds
tornado	tornadoes	tornados
lottery	lotteries
secretly
loudly
moisture	moistures
outrageous
damp	damped	dampest	damping	dampings	damps
grim	grimmer	grimmest
thirteen	thirteener	thirteens
ponder	pondered	pondering	ponders
swiss	swisser	swisses
caption	captioned	captioning	captions
ace	aced	aces	acing
adverse	adverser	adversest
stabilize	stabilized	stabilizes	stabilizing
controller	controllers
wax	waxed	waxes	waxing
deaf	deafer	deafest	deaves
overtime	overtimes
staffer	staffers
shiver	shivered	shiverings	shivers
disposal	disposals
kindergarten	kindergartens
crunch	crunched	crunches	crunching
intern	interned	internes	interning	interns
correspondence	correspondences
spectator	spectators
accordance	accordances
daylight	daylights
asteroid	asteroids
strawberry	strawberries
fictional
renewable
conquer	conquered	conqueress	conqueresses	conquering	conquers
penetrate	penetrated	penetrates	penetrating
questionable
comb	combed	combes	combings	combs
owl	owls
optional
pee	peed	peeing	pees
flare	flared	flares	flaring
illegally
slump	slumped	slumping	slumps
stray	strayed	straying	strayings	strays
complement	complemented	complementing	complements
messy	messiest	messier
freshly
composite	composites
snatch	snatched	snatches	snatching
altar	altars
straightforward	straightforwarder	straightforwardest
overlap	overlapped	overlapping	overlaps
dividend	dividends
broadly
relevance	relevances
reassure	reassured	reassures	reassuring
sixty	sixties
hilarious
lime	limed	limes	liming	limings
haven	havens
vicious
enthusiastic
umbrella	umbrellas
temptation	temptations
randomly
mum	mums
gaming
undo	undid	undoes	undoings	undone	undosed
freezing
mortal	mortals
visiting
pub	pubs
supervision	supervisions
trajectory	trajectories
spear	speared	spearing	spears
playground	playgrounds
temporal	temporals
audition	auditioned	auditioning	auditions
offshore
assurance	assurances
runway	runways
nun	nuns
fond	fonder	fondest
financing
immense	immenser	immensest
harass	harassed	harasses	harassing	harassings
velocity	velocities
multiply	multiplies	multiplied	multiplying
waitress	waitressed	waitresses	waitressing	waitressings
efficacy	efficacies
submission	submissions
integral	integrals
astronomy	astronomies
cock	cocked	cocking	cocks
fling	flinging	flings	flung
oval	ovals
detector	detectors
prostitute	prostituted	prostitutes	prostituting
lengthy	lengthiest	lengthier
fringe	fringed	fringes	fringing
showcase	showcases
maple	maples
configuration	configurations
neuron	neurons
sandy	sandiest	sandier
sage	sageer	sager	sagest
blossom	blossomed	blossomings	blossoms
occurrence	occurrences
tribune	tribunes
mosquito	mosquitoes	mosquitos
miner	miners
reproduction	reproductions
beating
socioeconomic
frighten	frightened	frightening	frightens
bruise	bruised	bruises	bruising	bruisings
caucus	caucused	caucuses	caucusing	caucussed	caucusses	caucussing
alcoholic	alcoholics
clan	clans
mint	minted	minting	mints
proponent	proponents
slick	slicked	slickest	slicking	slickings	slicks
governmental
oyster	oystered	oystering	oysterings	oysters
culturally
abruptly
deduction	deductions
ginger	gingered	gingering	gingers
refusal	refusals
empathy	empathies
emergence	emergences
inning	innings
dub	dubbed	dubbing	dubs
brow	brows
odor	odors
legitimacy	legitimacies
imperative	imperatives
startle	startled	startles	startling	startlings
linebacker	linebackers
mutation	mutations
jewel	jeweled	jeweling	jewelled	jewelling	jewels
reunion	reunions
recreation	recreations
growl	growled	growlings	growls
tomb	tombs
amend	amended	amending	amends
pier	piers
dependence	dependences
inhabitant	inhabitants
scarf	scarfed	scarfing	scarfings	scarfs	scarves
easter	easters
cuff	cuffed	cuffing	cuffs
ham	hammed	hamming	hams
youngster	youngsters
embarrassment	embarrassments
complicate	complicated	complicates	complicating
recycle	recycled	recycles	recycling
interestingly
unacceptable
contempt	contempts
overturn	overturned	overturning	overturns
necklace	necklaces
underscore	underscored	underscores	underscoring
qualification	qualifications
interim	interims
monk	monks
brazilian	brazilians
salesman	salesmen
dentist	dentists
aloud
sober	sobered	soberer	soberest	sobering	sobers
vivid	vivider	vividest
linger	lingered	lingerings	lingers
prototype	prototypes
pyramid	pyramided	pyramides	pyramiding	pyramids
moan	moaned	moaning	moans
peninsula	peninsulas
calcium	calciums
homemade
tout	touted	touting	touts
microwave	microwaved	microwaves	microwaving
gratitude	gratitudes
bum	bummed	bumming	bums
squash	squashed	squashes	squashing	squashs
pearl	pearled	pearling	pearlings	pearls
perfection	perfections
squat	squats	squatted	squattest	squatting
diplomacy	diplomacies
bypass	bypassed	bypasses	bypassing	bypast
reviewer	reviewers
metro	metros
lag	lagged	lagging	lags
peculiar
overview	overviews
exemption	exemptions
awhile
cathedral	cathedrals
widen	widened	widenesses	widening	widens
contradict	contradicted	contradicting	contradicts
horizontal	horizontals
mattress	mattresses
minus	minuses
pakistani	pakistanis
dictionary	dictionaries
keen	keened	keener	keenest	keening	keenings	keens
overweight	overweights
sausage	sausages
abusive
groom	groomed	grooming	grooms
batch	batched	batches	batching	batchings
divert	diverted	diverting	diverts
optical
sorrow	sorrowed	sorrowing	sorrowings	sorrows
atmospheric
spa	spas
marginal
upright	uprights
keyword
penis	penises
luckily
statewide
brotherhood	brotherhoods
differentiate	differentiated	differentiates	differentiating
qualitative
canyon	canyons
volcano	volcanoes	volcanos
layout	layouts
unintelligible
prone	proner	pronest
clone	cloned	clones	clonings
poise	poised	poises	poising
valve	valves
amen	amens
coordination	coordinations
feminine	feminines
rewrite	rewrites	rewritings	rewritten	rewrote
exclusion	exclusions
dread	dreaded	dreader	dreading	dreads
ecology	ecologies
rocky	rockiest	rockier
compost	composted	composting	composts
breeding
drape	draped	drapes	draping
plausible
revival	revivals
scam	scams
aggregate	aggregated	aggregates	aggregating
seasonal	seasonals
knight	knighted	knightess	knighting	knights
scoring
deployment	deployments
outdoors
thinker	thinkers
hitter	hitters
diagnostic
beneficiary	beneficiaries
reconciliation	reconciliations
cigar	cigars
wool	wools
entail	entailed	entailing	entails
deviation	deviations
sweeping
puff	puffed	puffings	puffs
shopper	shoppers
dental	dentals
footstep	footsteps
sticker	stickers
credential	credentials
delegation	delegations
encouragement	encouragements
incoming	incomings
kindness	kindnesses
chapel	chapels
nineteenth	nineteenths
parole	paroled	parolees	paroles	paroling
decay	decayed	decaying	decays
rationale	rationales
sincere	sincerer	sincerest
secondly
verge	verged	verges	verging
lethal
excel	excelled	excelling	excels
intentionally
briefing
newcomer	newcomers
modeling
whiskey	whiskeys
nowadays
probable	probables
cannon	cannoned	cannoning	cannons
selective
trademark	trademarked	trademarking	trademarks
vine	vines
mist	misted	misting	mistings	mists
asthma	asthmas
adhere	adhered	adheres	adhering
prairie	prairies
footnote	footnoted	footnotes	footnoting
interpreter	interpreters
protagonist	protagonists
evacuate	evacuated	evacuates	evacuating
citation	citations
fingerprint	fingerprinted	fingerprintings	fingerprints
stripe
deprive	deprived	deprives	depriving
heating
timeline	timelines
unfamiliar
intimacy	intimacies
battlefield	battlefields
formulate	formulated	formulates	formulating
saw	sawed	sawing	sawn	saws
query	queries	queried	querying	queryings
insure	insureds	insures	insuring
dictator	dictators
rebellion	rebellions
bankrupt	bankrupted	bankrupting	bankrupts
balcony	balconies
architectural
torch	torched	torches	torching	torchings
diaper	diapers
contender	contenders
paycheck	paychecks
landlord	landlords
meadow	meadows
flooding
settler	settlers
spectacle	spectacles
quarterly	quarterlies
greeting
china	chinas
boycott	boycotted	boycotting	boycotts
rigid	rigider	rigidest
foil	foiled	foilings	foils
fertility	fertilities
fumble	fumbled	fumbles	fumbling
comeback	comebacks
hose	hosed	hoses	hosing
damned	damneder	damnedest
clap	clapped	claps
oppression	oppressions
lame	lamer	lamest	lamester
barbecue	barbecued	barbecueing	barbecues	barbecuing
sampling
usher	ushered	usheress	usheresses	ushering	usherings	ushers
challenger	challengers
slogan	slogans
inflict	inflicted	inflicting	inflicts
imaginary	imaginaries
viral
machinery	machineries
calf	calfs
critically
precinct	precincts
width	widths
sew	sewed	sewing	sewn	sews
morale	morales
aye
optimal
countryside	countrysides
whisk	whisked	whisking	whisks
bleeding
comparative	comparatives
dissent	dissented	dissenting	dissents
fusion	fusions
soy
disadvantage	disadvantaged	disadvantages	disadvantaging
boo	booed	booing	boos
chore	chores
sequel	sequels
disparity	disparities
stitch	stitched	stitches	stitchings
standpoint	standpoints
firing
efficiently
nitrogen	nitrogens
solidarity	solidarities
pedal	pedaled	pedaling	pedalled	pedalling	pedals
unveil	unveiled	unveilings	unveils
tract	tracts
operative	operatives
appropriately
underwater
foremost
lively	liveliest	livelier
denounce	denounced	denounces	denouncing
intrigue	intrigued	intrigues	intriguess	intriguing
seizure	seizures
advancement	advancements
fascinate	fascinated	fascinates	fascinating
preschool	preschools
stark	starker	starkest
prohibition	prohibitions
repetition	repetitions
shovel	shoveled	shoveling	shovelled	shovelling	shovels
coral	corals
animation	animations
downward
charitable
devastate	devastated	devastates	devastating
disregard	disregarded	disregarding	disregards
tee	teed	teeing	tees
reef	reefed	reefing	reefings	reefs
sperm	sperms
emit	emits	emitted	emitting
nationalism	nationalisms
aviation	aviations
descendant	descendants
marshal	marshaled	marshaless	marshaling	marshalled	marshalling	marshals
reservoir	reservoirs
shepherd	shepherded	shepherdesses	shepherding	shepherds
courthouse	courthouses
trio	trios
allergy	allergies
fireplace	fireplaces
someplace
limp	limped	limpest	limpings	limps
timely	timeliest	timelier
homosexuality	homosexualities
apostle	apostles
asylum	asylums
mammal	mammals
accountant	accountants
turnout	turnouts
retention	retentions
vegetarian	vegetarians
bookstore	bookstores
caribbean	caribbeans
shred	shredded	shredding	shreds
coffin	coffined	coffining	coffins
shipping	shippings
evenly
artery	arteries
disciple	disciples
tailor	tailored	tailoress	tailoresses	tailorings	tailors
printing
withhold	withheld	withholdings	withholds
quantitative
bald	balded	balder	baldest	balding	balds
mid
smear	smeared	smearing	smears
perimeter	perimeters
bailout
inhabit	inhabited	inhabiting	inhabits
terminate	terminated	terminates	terminating
heir	heirs
chili	chilis
flank	flanked	flanking	flanks
occupational
roam	roamed	roaming	roamings	roams
roller	rollers
erect	erected	erecter	erecting	erects
cereal	cereals
referendum	referenda	referendums
wink	winked	winkings	winks
recruitment	recruitments
heroic	heroics
coyote	coyotes
anticipation	anticipations
validate	validated	validates	validating
observatory	observatories
dominance	dominances
polar
viewing
gardener	gardeners
comprehend	comprehended	comprehending	comprehends
dangle	dangled	dangles	danglings
disruption	disruptions
packet	packets
specification	specifications
hazardous
indoor
referral	referrals
caregiver	caregivers
supervise	supervised	supervisees	supervises	supervising
fellowship	fellowships
dime
adequately
outreach	outreaches
foam	foamed	foaming	foamings	foams
exterior	exteriors
notorious
skillet	skillets
unwilling
porn
boxer	boxers
abundant
exert	exerted	exerting	exerts
tow	towed	towing	tows
circular	circulars
visually
severity	severities
staple	stapled	staples	stapling
spontaneous
miniature	miniatures
hemisphere	hemispheres
pillar	pillars
cone
chuck	chucked	chucking	chucks
resentment	resentments
investigative
blessed	blesseder	blessedest
electorate	electorates
beverage	beverages
notification	notifications
unpleasant
interrogation	interrogations
wrestling
digest	digested	digesting	digests
synthetic	synthetics
discretion	discretions
dean	deans
reconcile	reconciled	reconciles	reconciling
altitude	altitudes
magnet	magnets
acquaintance	acquaintances
exempt	exempted	exempting	exempts
pedestrian	pedestrians
disturbance	disturbances
vibrant
freelance	freelanced	freelances	freelancing
binding
embarrass	embarrassed	embarrasses	embarrassing
fetch	fetched	fetches	fetching
livestock	livestocks
literal	literals
incomplete
proxy	proxies
hype	hyped	hypes	hyping
tier	tiers
spacecraft	spacecrafts
fury	furies
recreational
indirect
differential	differentials
discomfort	discomforts
stump	stumped	stumping	stumps
crank	cranked	cranker	crankest	cranking	cranks
probation	probations
strategist	strategists
catastrophe	catastrophes
arrogant
inconsistent
cleanup	cleanups
appliance	appliances
upload	uploaded	uploading	uploads
sustainability	sustainabilities
inexpensive
bunny	bunnies
plantation	plantations
reopen	reopened	reopening	reopenings	reopens
outlaw	outlawed	outlawing	outlaws
discriminate	discriminated	discriminates	discriminating
nursery	nurseries
oddly
mimic	mimicked	mimicking	mimics
blunt	blunted	blunter	bluntest	blunting	blunts
wrestle	wrestled	wrestles	wrestlings
savage	savaged	savager	savages	savagess	savagest	savaging
detain	detained	detaining	detains
grandson	grandsons
vault	vaulted	vaultings	vaults
understandable
gravel	graveled	graveless	graveling	gravelled	gravelling	gravels
proximity	proximities
trench	trenched	trenches	trenching
flashlight	flashlights
commute	commuted	commutes	commuting
offspring	offsprings
ripe	riper	ripest
spawn	spawned	spawning	spawnings	spawns
kindle	kindled	kindles	kindless	kindlings
sticky
skeleton	skeletons
seventeen	seventeens
syrup	syrups
helpless
tariff	tariffed	tariffing	tariffs
resonate	resonated	resonates	resonating
manifestation	manifestations
harness	harnessed	harnesses	harnessing
grammar	grammars
psychic	psychics
lobster	lobsters
mustard	mustards
loosen	loosened	loosenesses	loosening	loosens
covenant	covenanted	covenanting	covenants
disappearance	disappearances
millionaire	millionaires
superstar	superstars
muse	mused	muses	musings
mutant	mutants
maturity	maturities
zoom	zoomed	zooming	zooms
crossing
cardboard	cardboards
dietary	dietaries
dodge	dodged	dodges	dodgings
theorist	theorists
lash	lashed	lashes	lashings
moron	morons
token	tokens
worrying
stool	stooled	stooling	stools
diesel	diesels