aggressively
continuity	continuities
hacker	hackers
rein	reined	reining	reins
unleash	unleashed	unleashes	unleashing
intercept	intercepted	intercepting	intercepts
meaningless
deficiency	deficiencies
urgency	urgencies
broadcasting
ammunition	ammunitions
arbitrary
genetically
predominantly
quilt	quilted	quiltings	quilts
interception	interceptions
broth	broths
cushion	cushioned	cushioning	cushions
maternal
safeguard	safeguarded	safeguarding	safeguardings	safeguards
rigorous
conjunction	conjunctions
onset	onsets
awe	awed	awes	awing
veil	veiled	veilings	veils
burial	burials
royalty	royalties
newborn	newborns
scholarly
dwell	dwelled	dwellings	dwells	dwelt
progression	progressions
mini	minier	miniest	minis
tester	testers
allocate	allocated	allocates	allocating
loading
tuna	tunas
proudly
stunt	stunted	stunting	stunts
freeway	freeways
pew	pews
disappoint	disappointed	disappointing	disappoints
merchandise	merchandised	merchandises	merchandisings
unstable	unstabler	unstablest
membrane	membranes
wholly
conditioning
sprout	sprouted	sproutings	sprouts
evidently
signify	signifies	signifying	signifyings
lust	lusted	lusting	lusts
mistress	mistresses
dedication	dedications
worthwhile
berry	berries	berried	berrying	berryings
genocide	genocides
victorian	victorians
responsive
carriage	carriages
mourn	mourned	mournings	mourns
compatible
exaggerate	exaggerated	exaggerates	exaggerating
perfume	perfumed	perfumes	perfuming
prophecy	prophecies
gem	gems
feminism	feminisms
oblige	obliged	obligees	obliges	obliging
disconnect	disconnected	disconnecting	disconnects
wary	wariest	warier
cleaner	cleaners
thug	thugs
fridge	fridges
den	dens
template	templates
neatly
gunman	gunmen
lament	lamented	lamenting	lamentings	laments
situate	situated	situates	situating
adore	adored	adores	adoring
squirrel	squirrels
disgust	disgusted	disgusting	disgusts
ample	ampler	amplest
majesty	majesties
collectively
behold	beheld	beholden	beholdings	beholds
confidential
continuously
intimidate	intimidated	intimidates	intimidating
bash	bashed	bashes	bashing	bashings
thermal	thermals
respiratory
insufficient
inherently
billionaire	billionaires	billionairess	billionairesses
definitive
insurgent	insurgents
refrain	refrained	refraining	refrains
indulge	indulged	indulges	indulging
coconut	coconuts
rag	raged	rages	ragging	raging	rags
dressing
smoothly
flirt	flirted	flirtings	flirts
intensify	intensifies	intensified	intensifying
caring
petroleum	petroleums
devotion	devotions
confederate	confederated	confederater	confederates	confederating
unpredictable
descriptive
conform	conformed	conforming	conforms
posting
goddess	goddesses
bra	bras
exclaim	exclaimed	exclaiming	exclaims
brag	brager	bragged	brags
extinction	extinctions
hanging
sermon	sermons
leftist	leftists
remnant	remnants
migrate	migrated	migrates	migrating
chess	chesses
contention	contentions
inferior	inferiors
dire	direr	direst
uranium	uraniums
garment	garmented	garmenting	garments
imaging
unwanted
shifting
potent
decree	decreed	decreeing	decrees	decreing
performing
enzyme	enzymes
orphan	orphaned	orphaning	orphans
niece	nieces
decisive
resistant
imminent
intermediate	intermediated	intermediates	intermediating
remainder	remaindered	remaindering	remainders
refine	refined	refines	refinings
embark	embarked	embarking	embarks
traumatic
thereafter
northwestern	northwesterner
ozone	ozones
hardship	hardships
linguistic
environmentalist	environmentalists
recite	recited	recites	reciting
therapeutic	therapeutics
playing
finale	finales
pod	podded	podding	pods
bolster	bolstered	bolstering	bolsterings	bolsters
starve	starved	starves	starvings
surpass	surpassed	surpasses	surpassing
questioning
bribe	bribed	bribees	bribes	bribing
lousy	lousiest	lousier
substantive	substantives
comedian	comedians
hurdle	hurdled	hurdles	hurdlings
societal
smoker	smokers
pilgrim	pilgrims
bracelet	bracelets
homer	homered	homering	homers
skepticism	skepticisms
worthless
crouch	crouched	crouches	crouching
cherokee	cherokees
cater	catered	cateress	cateresses	caterings	caters
vector	vectors
footprint	footprints
jersey	jerseys
telling
courtyard	courtyards
lunar
leftover	leftovers
finely
kidnapping	kidnappings
bulletin	bulletined	bulletining	bulletins
eternity	eternities
portal	portals
singing
shed	sheder	sheds
spelling
vomit	vomited	vomitings	vomits
whore	whored	whores	whoring
bracket	bracketed	bracketing	brackets
opener	openers
overwhelmingly
parasite	parasites
embryo	embryos
siren	sirens
cradle	cradled	cradles	cradling	cradlings
simmer	simmered	simmering	simmers
infectious
decoration	decorations
idle	idled	idles	idlesses	idlest	idling
clove	cloves
coincide	coincided	coincides	coinciding
stressful
variant	variants
globalization	globalizations
blogging
alignment	alignments
tactical
wrinkle	wrinkled	wrinkles	wrinkling
imitate	imitated	imitates	imitating
undercover
relocate	relocated	relocatees	relocates	relocating
deceive	deceived	deceives	deceiving
resurrection	resurrections
rapist	rapists
salute	saluted	salutes	saluting
exploitation	exploitations
calling
skeptic	skeptics
rove	roved	roves	rovings
rot	rots	rotted	rotting
smiling
steering
uncommon	uncommoner	uncommonest
catastrophic
profoundly
paranoid	paranoids
programmer	programmers
distort	distorted	distorting	distorts
turbine	turbines
willow	willows
hiss	hissed	hisses	hissings
linen	linens
negatively
buckle	buckled	buckles	buckling	bucklings
huddle	huddled	huddles	huddling
demise	demised	demises	demising
swarm	swarmed	swarming	swarmings	swarms
revisit	revisited	revisiting	revisits
proliferation	proliferations
pony	ponies
scroll	scrolled	scrolling	scrolls
infamous
outward
succession	successions
freezer	freezers
alumnus	alumni
flex	flexed	flexes	flexing
jeep	jeeps
horrific
keeper	keepers
enrich	enriched	enriches	enriching
vain	vainer	vainest
allocation	allocations
unrelated
dispose	disposed	disposes	disposing	disposings
velvet	velvets
directory	directories
blush	blushed	blushes	blushing	blushings
recorder	recorders
strangely
geographical
rightly
flake	flaked	flakes	flaking
gunshot	gunshots
supernatural	supernaturals
squint	squinted	squintest	squinting	squintings	squints
rant	ranted	rantings	rants
radically
renewal	renewals
stubborn	stubborner	stubbornest
definite
fearful
rethink	rethinking	rethinks	rethought
postpone	postponed	postpones	postponing
cedar	cedars
resent	resented	resenting	resents
cinnamon	cinnamons
pussy	pussies	pussiest	pussier
archaeologist	archaeologists
spirituality	spiritualities
feat	feats
pharmacy	pharmacies
crave	craved	craves	cravings
poker	pokers
rogue	rogues
variability	variabilities
implicit
cartel	cartels
savior	saviors
pasture	pastured	pastures	pasturing
swift	swifter	swiftest	swifts
overthrow	overthrew	overthrowing	overthrown	overthrows
pancake	pancakes
elevation	elevations
fundamentalist	fundamentalists
trek	trekked	trekking	treks
novelist	novelists
rite	rites
mobilize	mobilized	mobilizes	mobilizing
postal
greedy	greediest	greedier
heterosexual	heterosexuals
foreclosure	foreclosures
curator	curators
promptly
misunderstanding
tweak	tweaked	tweaking	tweakings	tweaks
rinse	rinsed	rinses	rinsings
turmoil	turmoils
prevalent
canon	canons
irrational	irrationals
ripple	rippled	ripples	ripplings
starving
forthcoming
cracker	crackers
extensively
leisure	leisures
paradox	paradoxes
rivalry	rivalries
simplicity	simplicities
brew	brewed	brewings	brews
fort	forted	fortes	forting	forts
indict	indicted	indicting	indicts
muddy	muddier	muddies	muddiest	muddied	muddying	muddyings
nanny	nannies
forensic
constructive
expel	expelled	expelling	expels
urine	urines
champ	champed	champing	champs
voyage	voyaged	voyages	voyaging	voyagings
captive	captives
vegetation	vegetations
legion	legioner	legions
tangible
benchmark	benchmarks
systemic
elimination	eliminations
buddhist	buddhists
athletics
earnest	earnests
insulin	insulins
incapable
signing
prestigious
appropriation	appropriations
persona	personae	personas
chancellor	chancellors
propel	propelled	propelling	propels
poetic
verb	verbs
erosion	erosions
displace	displaced	displaces	displacing
unusually
attacker	attackers
masterpiece	masterpieces
inclusive
deter	detering	deterred	deterring	deters
communion	communions
certify	certifies	certified	certifying
textile	textiles
reliance	reliances
enjoyment	enjoyments
sucker	suckers
paddle	paddled	paddles	paddling	paddlings
commonwealth	commonwealths
contamination	contaminations
hypothetical	hypotheticals
butcher	butchered	butcheress	butcherings	butchers
sickness	sicknesses
shutdown	shutdowns
antibody	antibodies
nucleus	nuclei	nucleuses
restrain	restrained	restraining	restrainings	restrains
mainland	mainlands
paw	pawed	pawing	paws
myriad	myriads
inquire	inquired	inquires	inquiring
compute	computed	computes	computing
duplicate	duplicated	duplicates	duplicating
planetary
parlor	parlors
grader	graders
howl	howled	howlings	howls
directive	directives
stew	stewed	stewings	stews
postwar
brigade	brigaded	brigades	brigading
honorable
scarce	scarcer	scarcest
bluff	bluffed	bluffest	bluffing	bluffs
populate	populated	populates	populating
plow	plowed	plowing	plows
pastry	pastries
cynical
marital
reckon	reckoned	reckonings	reckons
turf	turfed	turfing	turfings	turfs	turves
madame	madames	mesdames
condo	condos
orient	oriented	orienting	orients
fertilizer	fertilizers
depot	depots
allegiance	allegiances
hindu	hindus
receptor	receptors
autopsy	autopsies	autopsying
digit	digits
elicit	elicited	eliciting	elicits
earring	earrings
coupon	coupons
submarine	submarined	submarines	submarining
uprising
subsidize	subsidized	subsidizes	subsidizing
betrayal	betrayals
vanity	vanities
cozy	cozies	coziest	cozier
shudder	shuddered	shuddering	shudderings	shudders
internationally
icy	iciest	icier
nexus	nexuses
clearance	clearances
respectful
genetics
fitting	fittings
coherent
premature
amusement	amusements
crumble	crumbled	crumbles	crumbling	crumblings
hog	hogged	hogging	hogs
abolish	abolished	abolishes	abolishing
conductor	conductors
flicker	flickered	flickering	flickers
discrepancy	discrepancies
formidable
weary	wearier	wearies	weariest	wearied	wearying
ordinance	ordinances
cuisine	cuisines
misunderstand	misunderstanded	misunderstandings	misunderstands	misunderstood
trickle	trickled	trickles	trickless	trickling	tricklings
vacant
repay	repaid	repayed	repaying	repays
crane	craned	cranes	craning
chatter	chattered	chatterings	chatters
stagger	staggered	staggering	staggerings	staggers
pluck	plucked	plucking	plucks
inhale	inhaled	inhales	inhaling
rumble	rumbled	rumbles	rumblings
disastrous
browse	browsed	browses	browsings
villager	villagers
guerrilla	guerrillas
intrinsic
solitary	solitaries
cellphone	cellphones
auburn
sideways
indirectly
pave	paved	paveed	paves	pavings
bunker	bunkered	bunkering	bunkers
activism	activisms
noodle	noodles
quota	quotas
wetland	wetlands
disposition	dispositions
capsule	capsuled	capsules	capsuling
assassin	assassins
raven	ravened	ravening	ravenings	ravens
overhaul	overhauled	overhauling	overhauls
redemption	redemptions
inhibit	inhibited	inhibiting	inhibits
grad	grads
harmless
grease	greased	greases	greasing
creditor	creditors
broadway	broadways
vaguely
nude	nuder	nudes	nudest
irresponsible
equate	equated	equates	equating
buffer	buffered	buffering	buffers
sterling	sterlings
martial	martials
remotely
vastly
plasma	plasmas
clergy	clergies
endanger	endangered	endangering	endangers
vineyard	vineyards
jelly	jellies	jellied	jellying
relentless
hunch	hunched	hunches	hunching
reconsider	reconsidered	reconsidering	reconsiders
constituency	constituencies
eligibility	eligibilities
quiz	quizes	quizzed	quizzes	quizzing
backdrop	backdrops
mesh	meshed	meshes	meshings
hinge	hinged	hinges	hinging
skier	skiers
noisy	noisiest	noisier
shipment	shipments
plaster	plastered	plasterings	plasters
filthy	filthiest	filthier
vaccination	vaccinations
brit	brits
prose	proses
advertiser	advertisers
grower	growers
confer	conferred	conferring	confers
glide	glided	glides	glidings
camping
unconstitutional
takeover	takeovers
fuse	fused	fusees	fuses	fusing
artillery	artilleries
pavement	pavements
cutter	cutters
gardening
reflective
savvy	savvies	savvied	savvying
feasible
shuffle	shuffled	shuffles	shufflings
eventual
ape	aped	apes	aping
blackberry	blackberries	blackberrying	blackberryings
reset	resets	resetting
sniper	snipers
pressing
examiner	examiners
volatile	volatiles
compartment	compartments
billboard	billboards
modem	modems
unsure	unsurer	unsurest
precaution	precautions
fuzzy	fuzziest	fuzzier
perpetuate	perpetuated	perpetuates	perpetuating
derivative	derivatives
shrine	shrined	shrines	shrining
loaf	loafed	loafings	loafs	loaves
catcher	catchers
sitting	sittings
intentional
enjoyable
transcend	transcended	transcending	transcends
fuss	fussed	fusses	fussing
apparatus	apparatuses
synthesis	syntheses
deepen	deepened	deepening	deepens
classified	classifieds
susceptible
tractor	tractors
remake	remade	remakes	remaking
finn	finns
crater	craters
broaden	broadened	broadenings	broadens
flop	flopped	flopping	flops
analytical
stereo	stereos
revolve	revolved	revolves	revolving	revolvings
mediate	mediated	mediates	mediating
comrade	comrades
infantry	infantries
voucher	vouchers
contingent	contingents
escalate	escalated	escalates	escalating
baron	barons
gag	gaged	gages	gagged	gagging	gaging	gags
deception	deceptions
cardiovascular
methodist	methodists
spokesperson	spokespersons
voluntarily
attic	attics
rotten	rottener	rottenest
factual
rhyme	rhymed	rhymes	rhyming
amnesty	amnesties	amnestied	amnestying
oneself
lipstick	lipsticked	lipsticking	lipsticks
lucrative
chord	chorded	chording	chordings	chords
bearing
appendix	appendices	appendixes
adorable
constrain	constrained	constraining	constrains
notch	notched	notches	notching	notchings
tenth	tenths
adversary	adversaries
napkin	napkins
woo	wooed	wooing	woos
subordinate	subordinated	subordinates	subordinating
territorial	territorials
recess	recessed	recesses	recessing
superb	superber	superbest
competency	competencies
gadget	gadgets
gradual	graduals
fidelity	fidelities
stash	stashed	stashes	stashing
dismantle	dismantled	dismantles	dismantling
gal	gals
hen	hens
withstand	withstanding	withstands	withstood
walnut	walnuts
pervasive
distortion	distortions
anomaly	anomalies
ideally
breakup	breakups
anonymity	anonymities
singular	singulars
thankfully
cafeteria	cafeterias
instability	instabilities
saga	sagas
thereof
crow	crowed	crowing	crows
sensibility	sensibilities
sewer	sewers
rehab
traitor	traitors
lightweight	lightweights
foe	foes
coward	cowards
lurk	lurked	lurking	lurkings	lurks
cascade	cascaded	cascades	cascading
luggage	luggages
catalogue	catalogued	catalogues	cataloguing
razor	razored	razoring	razors
visibility	visibilities
tutor	tutored	tutoress	tutoresses	tutoring	tutorings	tutors
bodily
informant	informants
reckless
ambiguity	ambiguities
neural
snort	snorted	snortings	snorts
vigorous
stakeholder	stakeholders
fetus	fetuses
communal
serum	sera	serums
perk	perked	perking	perks
cloak	cloaked	cloaking	cloaks
authoritarian	authoritarians
photographic
tally	tallies	tallied	tallying
queer	queered	queerer	queerest	queering	queers
helping
seafood	seafoods
violin	violins
allowance	allowanced	allowances	allowancing
prostate	prostates
reap	reaped	reaping	reaps
scanner	scanners
misconduct	misconducted	misconducting	misconducts
nudge	nudged	nudges	nudging
anthropology	anthropologies
subpoena	subpoenaed	subpoenaing	subpoenas
ambiguous
vodka	vodkas
wield	wielded	wielding	wields
elevated
comfortably
subsidiary	subsidiaries
patio	patios
knowledgeable
loneliness	lonelinesses
bravo	bravoed	bravoes	bravoing	bravos
sync	synced	syncing	syncs
dusk	dusked	dusking	dusks
impair	impaired	impairing	impairings	impairs
blouse	blouses
beep	beeped	beeping	beeps
preside	presided	presides	presiding
camel	camels
perennial	perennials
hull	hulled	hulling	hulls
grit	grits	gritted	gritting
pest	pests
hustle	hustled	hustles	hustling	hustlings
persistence	persistences
moist	moister	moistest
sunrise	sunrises
pixel	pixels
tread	treaded	treading	treadings	treads	trod	trodden
righteous
retiree
characterization	characterizations
prom	proms
mule	mules
refund	refunded	refunding	refunds
township	townships
mumble	mumbled	mumbles	mumblings
casually
sturdy	sturdiest	sturdier
provincial	provincials
siege	sieges
ivory	ivories
compassionate	compassionated	compassionates	compassionating
podcast	podcasting	podcasts
tasty	tastiest	tastier
geek	geeks
fungus	funguses
reinforcement	reinforcements
cardiac
despise	despised	despises	despising
crate	crated	crates	crating
baggage	baggages
judgement	judgements
yogurt	yogurts
pierce	pierced	pierces	piercing	piercings
enlightenment	enlightenments
reclaim	reclaimed	reclaiming	reclaims
bumper	bumpers
hoop	hooped	hooping	hoops
trumpet	trumpeted	trumpeting	trumpetings	trumpets
exacerbate	exacerbated	exacerbates	exacerbating
elf	elves
fatty	fatties	fattiest	fattier
systematically
famously
bartender	bartenders
chaotic
ineffective
shack	shacked	shacking	shackings	shacks
ethanol	ethanols
commandment	commandments
radioactive
ridicule	ridiculed	ridicules	ridiculing
renovation	renovations
residue	residues
layoff	layoffs
notwithstanding
milky	milkiest	milkier
backlash	backlashed	backlashes	backlashing
tangle	tangled	tangles	tangless	tangling	tanglings
heartbeat	heartbeats
farewell	farewells
influenza	influenzas
clamp	clamped	clamping	clamps
accidental	accidentals
lettuce	lettuces
commuter	commuters
crest	crested	cresting	crestings	crests
darn	darnings	darns
slender	slenderer	slenderest
abide	abided	abides	abiding	abidings
anthropologist	anthropologists
theologian	theologians
insanity	insanities
categorize	categorized	categorizes	categorizing
rhetorical
villa	villas
groove	grooved	grooves	grooving
subtitle	subtitled	subtitles	subtitling
perpetrator	perpetrators
promoter	promoters
southeastern	southeasterner
moonlight	moonlighted	moonlighting	moonlightings	moonlights
terrace	terraced	terraces	terracing	terracings
crusade	crusaded	crusades	crusading
duo	duos
pornography
pundit	pundits
dye	dyed	dyeing	dyes
greatness	greatnesses
realism	realisms
binary	binaries
dictatorship	dictatorships
setback	setbacks
interviewer	interviewers
buffet	buffeted	buffetings	buffets
hopeless
clearing
accumulation	accumulations
multitude	multitudes
sane	saner	sanest
presently
autonomous
lever	levered	levering	levers
woe	woes
mitigate	mitigated	mitigates	mitigating
bowling
borrower	borrowers
frank	franked	franker	frankest	franking	franks
rash	rashes	rashest
yup
respectable
gel	gelled	gelling	gels
renowned
secrecy	secrecies
downhill	downhiller	downhills
bureaucrat	bureaucrats
mutually
admiration	admirations
parenthood	parenthoods
lad	lads
unload	unloaded	unloadings	unloads
almond	almonds
guild	guilds
energetic
kindly	kindliest	kindlier
inflammation	inflammations
guru	gurus
rainy	rainiest	rainier
taxation	taxations
elusive
sparkle	sparkled	sparkles	sparkless	sparklings
floating
inheritance	inheritances
antenna	antennae	antennas
degrade	degraded	degrades	degrading
ignite	ignited	ignites	igniting
aerial	aerials
desperation	desperations
provocative
evacuation	evacuations
nutritional
pact	pacts
apt	apter	aptest
discern	discerned	discerning	discerns
carnival	carnivals
masculine	masculines
aspire	aspired	aspires	aspiring
postcard	postcards
bacterial
flyer	flyers
cram	crames	crammed	cramming	crams
shriek	shrieked	shriekings	shrieks
loosely
deposition	depositions
ethic	ethics
dope	doped	dopes	doping	dopings
slippery
lingering
golfer	golfers
trivial
hinder	hindered	hinderer	hinderest	hindering	hinders
stellar
professionally
concussion	concussions
mortar	mortared	mortaring	mortars
nigger	niggers
segregation	segregations
biscuit	biscuits
lumber	lumbered	lumberings	lumbers
grate	grated	grates	gratings
vibration	vibrations
beetle	beetled	beetler	beetles	beetling	beetlings
constellation	constellations
relish	relished	relishes	relishing
haitian	haitians
milligram	milligrams
prestige	prestiges
tack	tacked	tackings	tacks
battalion	battalions
obese	obeser	obesest
adolescence	adolescences
arsenal	arsenals
acoustic	acoustics
marvelous
brink	brinks
outing
knit	knits	knitted
dorm	dorms
peripheral	peripherals
honeymoon	honeymooned	honeymooning	honeymoons
reversal	reversals
multicultural
rake	raked	rakees	rakes	raking	rakings
marxist	marxists
contaminate	contaminated	contaminates	contaminating
revolt	revolted	revolting	revolts
adobe	adobes
gigantic
bureaucratic
muscular
czech	czechs
wardrobe	wardrobes
awfully
plaque	plaques
airway	airways
censor	censored	censoring	censors
going
incur	incurred	incurring	incurs
blueprint	blueprinted	blueprinting	blueprints
daytime	daytimes
wail	wailed	wailings	wails
endowment	endowments
readiness	readinesses
calmly
symbolize	symbolized	symbolizes	symbolizing
phony	phonies	phoniest	phonier
friction	frictions
handcuff	handcuffed	handcuffing	handcuffs
sinner	sinners
implicate	implicated	implicates	implicating
reprint	reprinted	reprintings	reprints
adulthood	adulthoods
tabloid	tabloids
unreasonable
dent	dented	dentes	denting	dents
sincerely
bakery	bakeries
allergic
avert	averted	averting	averts
theoretically
domination	dominations
nigga	niggas
sensory
bilateral
bounty	bounties
wholesale	wholesaled	wholesales	wholesaling
fixture	fixtures
toxin	toxins
intercourse	intercourses
lending
spam	spams
patriotic
depiction	depictions
erode	eroded	erodes	eroding
crumb	crumbed	crumbing	crumbs	crumbses
intuition	intuitions
garnish	garnished	garnishes	garnishing	garnishings
sling	slinging	slings	slung
phantom	phantoms
numb	numbed	numberer	numbest	numbing	numbs
hue	hued	hues
fingertip	fingertips
hay	hayed	haying	hays
liable
pickle	pickled	pickles	pickling
interpersonal
motif	motifs	motives
admittedly
font	fonts
inaccurate
formulation	formulations
dine
uneasy
sleepy	sleepiest	sleepier
strait	straiter	straitest	straits
infrared	infrareds
salvage	salvaged	salvagees	salvages	salvaging
popcorn	popcorns
lush	lusher	lushes	lushest
vegan	vegans
windshield	windshields
waiver	waivers
culinary
detainee	detainees
buzz	buzzed	buzzes	buzzing	buzzings
hound	hounded	hounding	hounds
broke
canoe	canoed	canoeing	canoeings	canoes	canoing
consolidate	consolidated	consolidates	consolidating
madam	madams
hawaiian	hawaiians
fascination	fascinations
filling
tsunami	tsunamis
spinach	spinaches
sleek	sleeked	sleeker	sleekest	sleeking	sleekings	sleeks
obstruction	obstructions
globally
amaze	amazed	amazes	amazing
redefine	redefined	redefines	redefining
drunken
degradation	degradations
quake	quaked	quakes	quaking	quakings
ambush	ambushed	ambushes	ambushing
spinal	spinals
underlie	underlain	underlies	underlying
brochure	brochures
orderly	orderlies
boomer	boomers
atrocity	atrocities
insecurity	insecurities
incompetent	incompetents
lest
dependency	dependencies
wrench	wrenched	wrenches	wrenching	wrenchings
politely
mastery	masteries
contradictory	contradictories
peril	periled	periling	perils
packaging
shorten	shortened	shortenings	shortens
biodiversity	biodiversities
trooper	troopers
congratulate	congratulated	congratulates	congratulating
vibe	vibes
moderator	moderators