paralyze	paralyzed	paralyzes	paralyzing
mercury	mercuries
tar	tared	tares	taring	tarred	tarring	tars
intellect	intellects
override	overridden	overrides	overriding	overrode
catalyst	catalysts
collide	collided	collides	colliding
dubious
stud	studded	studding	studs
conquest	conquests
yacht	yachted	yachtings	yachts
spicy	spiciest	spicier
pragmatic	pragmatics
periodically
contestant	contestants
lapse	lapsed	lapses	lapsing
capitalize	capitalized	capitalizes	capitalizing
staircase	staircases
yearly	yearlies
alleviate	alleviated	alleviates	alleviating
dummy	dummies	dummied	dummying
enhancement	enhancements
openness	opennesses
irrigation	irrigations
distributor	distributors
parsley	parsleys
arrogance	arrogances
disbelief	disbeliefs
doctoral
cruelty	cruelties
culminate	culminated	culminates	culminating
compass	compassed	compasses	compassing	compassings
intensely
hypocrisy	hypocrisies
embargo	embargoed	embargoes	embargoing	embargos
canopy	canopies	canopied	canopying
churn	churned	churning	churnings	churns
runaway	runaways
theatrical	theatricals
pinpoint	pinpointed	pinpointing	pinpoints
jog	jogged	jogging	jogs
haircut	haircuts
delusion	delusions
loophole	loopholes
auditor	auditors
nickel	nickeled	nickeling	nickels
pointless
cylinder	cylinders
informative
wig	wigs
glacier	glaciers
chalk	chalked	chalking	chalks
persecution	persecutions
handicap	handicapped	handicapping	handicaps
stimulation	stimulations
heavenly
pi	pis
grenade	grenades
pigeon	pigeons
granite	granites
adaptive
apprentice	apprenticed	apprentices	apprenticing
wrath	wraths
coma	comae	comas
frenzy	frenzies
unexpectedly
registry	registries
vapor	vapors
simulate	simulated	simulates	simulating
haze	hazed	hazes	hazing	hazings
delightful
inventor	inventors
liberalism	liberalisms
hostess
enlarge	enlarged	enlarges	enlarging
thriller	thrillers
conjure	conjured	conjures	conjurings
mural	murals
stint	stinted	stinting	stintings	stints
rust	rusted	rustings	rusts
reformer	reformers
arthritis	arthritises
annoy	annoyed	annoying	annoys
alteration	alterations
pear	pears
referee	refereed	refereeing	referees
whereby
furnish	furnished	furnishes	furnishings
dune
disable	disabled	disables	disabling
stoop	stooped	stoopes	stooping	stoops
downside	downsides
quantify	quantifies	quantified	quantifying
benign	benigner	benignest
cumulative
causal
trot	trots	trotted	trotting
compression	compressions
purity	purities
cavity	cavities
buffalo	buffaloed	buffaloes	buffaloing	buffalos
milestone	milestones
herald	heralded	heraldess	heralding	heralds
analyse	analyses
harden	hardened	hardenings	hardens
lessen	lessened	lessening	lessens
stomp	stomped	stomping	stomps
climbing
skim	skimmed	skims
disruptive
casting
airborne
superiority	superiorities
denote	denoted	denotes	denoting
reiterate	reiterated	reiterates	reiterating
jeopardy	jeopardies
wade
simplify	simplifies	simplified	simplifying
turk	turks
imbalance	imbalances
hurl	hurled	hurlings	hurls
restless
memorize	memorized	memorizes	memorizing
loft	lofted	lofting	lofts
municipality	municipalities
martyr	martyred	martyress	martyring	martyrs
cruiser	cruisers
environmentally
activation	activations
replay	replayed	replaying	replays
invariably
physiological
liberate	liberated	liberates	liberating
coil	coiled	coiling	coils
sic	sicked	sicking	sics
disrespect	disrespected	disrespecting	disrespects
snapshot	snapshots
parcel	parceled	parceling	parcelled	parcelling	parcels
rehearse	rehearsed	rehearses	rehearsing	rehearsings
imprison	imprisoned	imprisoning	imprisons
overflow	overflowed	overflowing	overflowings	overflows
handbook	handbooks
enthusiast	enthusiasts
conversely
archaeological
anatomy	anatomies
jealousy	jealousies
focal
marketer	marketers
crooked	crookeder	crookedest
tyranny	tyrannies
unhealthy	unhealthiest	unhealthier
conservatism	conservatisms
cherish	cherished	cherishes	cherishing
stigma	stigmas	stigmata
heed	heeded	heeding	heeds
swiftly
cabbage	cabbaged	cabbages	cabbaging
demo	demoed	demoing	demos	demoses
metabolism	metabolisms
breaking
reunite	reunited	reunites	reuniting
designation	designations
flutter	fluttered	fluttering	flutters
humiliation	humiliations
temp	temps
residual	residuals
disperse	dispersed	disperses	dispersing
stupidity	stupidities
hamburger	hamburgers
privatization	privatizations
amazingly
abnormal
partition	partitioned	partitioning	partitions
extraordinarily
crook	crooking	crooks
raft	rafted	rafting	rafts
riddle	riddled	riddles	riddling	riddlings
orchard	orchards
infer	inferred	inferring	infers
latitude	latitudes
twitch	twitched	twitches	twitchings
radius	radii	radiuses
invasive
heroine	heroines
multinational
generosity	generosities
statutory
resemblance	resemblances
silhouette	silhouetted	silhouettes	silhouetting
immoral
landfill	landfills
ubiquitous
anecdote	anecdotes
prostitution	prostitutions
insistence	insistences
plight	plighted	plighting	plights
unpopular
sediment	sedimented	sedimenting	sediments
specially
geometry	geometries
immerse	immersed	immerses	immersing
whilst
preventive	preventives
cricket	cricketed	cricketing	cricketings	crickets
inaugural	inaugurals
archbishop	archbishops
helm	helmed	helming	helms
extraction	extractions
warp	warped	warpings	warps
shrub	shrubs
dominican	dominicans
internship	internships
rugged	ruggeder	ruggedest
multimedia	multimedias
libyan	libyans
nerd	nerds
payoff	payoffs
portrayal	portrayals
advent	advents
rave	raved	raves	ravings
diversion	diversions
conserve	conserved	conserves	conserving
discredit	discredited	discrediting	discredits
muster	mustered	mustering	musters
cookbook	cookbooks
lateral	laterals
uniquely
vengeance	vengeances
reconstruct	reconstructed	reconstructing	reconstructs
atlas	atlases
bleak	bleaker	bleakest
tame	tamed	tames	tamest	taming	tamings
fiery
equilibrium	equilibriums
cyclist	cyclists
nostalgia	nostalgias
surrogate	surrogates
autobiography	autobiographies
fascist	fascists
scarcely
mythology	mythologies
sprawl	sprawled	sprawling	sprawls
kin
dementia	dementias
cheerful
itch	itched	itches	itchings
seminary	seminaries
mantle	mantled	mantles	mantling	mantlings
humane
brightly
whack	whacked	whackings	whacks
northeastern
painfully
sow	sowed	sowing	sown	sows
drastically
cache	cached	caches	caching
granddaughter	granddaughters
convene	convened	convenes	convening
prick	pricked	prickings	pricks
metric	metrics
intricate
booster	boosters
pastel	pastels
nationality	nationalities
cooler	coolers
solicit	solicited	soliciting	solicitings	solicits
impatient
reminiscent
rubble	rubbles
courageous
disciplinary
superficial
agony	agonies
elk	elks
unseen	unseens
parliamentary
functionality	functionalities
alienate	alienated	alienates	alienating
authorization	authorizations
chemotherapy	chemotherapies
sabotage	sabotaged	sabotages	sabotaging
rapper	rappers
mislead	misleading	misleads	misled
hush	hushed	hushes	hushing
redeem	redeemed	redeeming	redeems
swipe	swiped	swipes	swiping
cellar	cellars
acceleration	accelerations
expressive
quotation	quotations
prosperous
undocumented
nightly
pounding
moose
seeker	seekers
torment	tormented	tormenting	tormentings	torments
liner	liners
handler	handlers
reluctantly
meteor	meteors
affluent	affluents
torso	torsi	torsos
misuse	misused	misuses	misusing
unsuccessful
inference	inferences
appraisal	appraisals
authenticity	authenticities
heater	heaters
watercolor	watercoloring	watercolors
astronomical
ornament	ornamented	ornamenting	ornaments
lineage	lineages
fertile	fertiler	fertilest
inland	inlander
maverick	mavericks
thump	thumped	thumping	thumps
negotiator	negotiators
autograph	autographed	autographing	autographs
decorative
consortium	consortia	consortiums
commence	commenced	commences	commencing
cripple	crippled	cripples	crippling	cripplings
proprietary	proprietaries
boarding
boulder	boulders
tribunal	tribunals
bob	bobbed	bobbing	bobs
exemplify	exemplifies	exemplified	exemplifying
forearm	forearmed	forearming	forearms
eighty	eighties
hospitality	hospitalities
platter	platters
subcommittee	subcommittees
sitcom	sitcoms
lantern	lanterns
volleyball	volleyballs
mar	mares	marred	marring	mars
ninja	ninjas
familiarity	familiarities
lesion	lesions
imitation	imitations
malaria	malarias
nineteen	nineteens
gracious
chilling
dove	doves
succumb	succumbed	succumbing	succumbs
humility	humilities
consciously
creamy	creamiest	creamier
vase
accessibility	accessibilities
pathogen	pathogens
dysfunction	dysfunctions
preseason	preseasons
expectancy	expectancies
laborer	laborers
marsh	marshes	marshs
drastic
topple	toppled	topples	toppling
womb	wombs
funnel	funneled	funneling	funnelled	funnelling	funnels
periodic
maze	mazes
auditorium	auditoria	auditoriums
reinvent	reinvented	reinventing	reinvents
pivotal
attendee	attendees
slug	slugged	slugging	slugs
suicidal
sweaty
validation	validations
sexist	sexists
legalize	legalized	legalizes	legalizing
violently
anthem	anthems
snag	snagged	snagging	snags
unify	unifies	unified	unifying	unifyings
disgrace	disgraced	disgraces	disgracing
sponge	sponged	sponges	sponging
sociology	sociologies
fingernail	fingernails
perpetual
bathe
lighten	lightened	lightenings	lightens
visualize	visualized	visualizes	visualizing
initiation	initiations
foresee	foresaw	foreseeing	foreseen	foresees	foreseing
thickness	thicknesses
apartheid	apartheids
longitudinal
downturn	downturns
nonexistent
amplify	amplifies	amplified	amplifying
shortcoming	shortcomings
pollutant	pollutants
duct	ducts
shear	sheared	shearings	shears
zionist	zionists
cycling
muffin	muffins
internally
housewife	housewives
novice	novices
normative
colon	colones	colons
disdain	disdained	disdaining	disdains
handgun	handguns
durable
arouse	aroused	arouses	arousing
covert	coverts
sloppy	sloppiest	sloppier
fallout	fallouts
cockpit	cockpits
parody	parodies	parodied	parodying
eagerly
buildup	buildups
devour	devoured	devouress	devouring	devours
abound	abounded	abounding	abounds
overhear	overheard	overhearing	overhears
outweigh	outweighed	outweighing	outweighs
needy	neediest	needier
demonstrator	demonstrators
grapple	grappled	grapples	grapplings
touching
plummet	plummeted	plummeting	plummets
mustache	mustaches
censorship	censorships
intellectually
endurance	endurances
reluctance	reluctances
unrealistic
rampant
dynasty	dynasties
bulge	bulged	bulges	bulging
contraction	contractions
flatten	flattened	flattening	flattens
danish	danishes
youthful
allude	alluded	alludes	alluding
hippie
veggie	veggies
estimation	estimations
tickle	tickled	tickles	tickless	ticklings
hooker	hookers
repression	repressions
shaky	shakiest	shakier
baseman
sewage	sewages
frantic
procedural
hillside	hillsides
generalization	generalizations
railing
cosmos	cosmoses
contingency	contingencies
continuum	continua	continuums
supplemental
backing
synagogue	synagogues
briefcase	briefcases
halo	haloes	halos
poultry	poultries
norwegian	norwegians
splendid	splendider	splendidest
noticeable
avid	avider	avidest
broccoli	broccolis
glaze	glazed	glazes	glazing	glazings
entrepreneurial
cubic
distrust	distrusted	distrusting	distrusts
preclude	precluded	precludes	precluding
podium	podia	podiums
lighter	lightered	lightering	lighters
kitten	kittened	kittening	kittens
rooftop	rooftops
peg	pegged	pegging	pegs
plum	plums
retaliation	retaliations
finite
swimmer	swimmers
tenet	tenets
bunk	bunked	bunking	bunks
fugitive	fugitives
indefinitely
slab	slabs
momma	mommas
martian	martians
seventy	seventies
sedan	sedans
sherry	sherries
checkpoint	checkpoints
midway	midways
narrowly
bun	buns
pudding	puddings
chime	chimed	chimes	chiming
pneumonia	pneumonias
suffice	sufficed	suffices	sufficing
seam	seamed	seames	seaming	seams
hesitation	hesitations
recollection	recollections
vigorously
uninsured
narcotic	narcotics
pastoral	pastorals
novelty	novelties
planting
monastery	monasteries
empowerment	empowerments
mole	moles
drummer	drummers
subset	subsets
diploma	diplomas
lizard	lizards
spew	spewed	spewing	spews
whirl	whirled	whirlings	whirls
walker	walkers
juicy	juiciest	juicier
creed	creeds
sub	subbed	subbing	subs
socialize	socialized	socializes	socializing
humiliate	humiliated	humiliates	humiliating
psalm	psalmed	psalming	psalms
purge	purged	purges	purgings
hitch	hitched	hitches	hitching
inflammatory
magician	magicians
psyche	psyches
contraception	contraceptions
braid	braided	braidings	braids
evaporate	evaporated	evaporates	evaporating
suppression	suppressions
resonance	resonances
subdivision	subdivisions
gravitational
automaker	automakers
dizzy	dizzier	dizzies	dizziest	dizzied	dizzying
knuckle	knuckled	knuckles	knuckling
pore	pored	pores	poring
clinician	clinicians
unrest	unrests
seduce	seduced	seduces	seducing	seducings
phenomenal
runoff	runoffs
eruption	eruptions
valuation	valuations
humidity	humidities
stifle	stifled	stifles	stiflings
microscope	microscopes
headphone	headphones
intuitive
installment	installments
saucepan	saucepans
approximate	approximated	approximates	approximating
fluctuation	fluctuations
boiling
schooling
graze	grazed	grazes	grazings
basil	basils
famine	famines
jeopardize	jeopardized	jeopardizes	jeopardizing
incidentally
soundtrack	soundtracks
trope	tropes
smuggle	smuggled	smuggles	smugglings
plateau	plateaus	plateaux
visionary	visionaries
titan	titans
redesign	redesigned	redesigning	redesigns
pry	pries	pried	prying
fume	fumed	fumes	fuming
apron	aprons
regimen	regimens
indoors
plank	planked	plankings	planks
palette	palettes
meltdown	meltdowns
chrome	chromed	chromes	chroming	chromings
persuasive
glitter	glittered	glittering	glitterings	glitters
deport	deported	deporting	deports
wisely
residency	residencies
linkage	linkages
brightness	brightnesses
optimize	optimized	optimizes	optimizing
mafia	mafias
dissertation	dissertations
fiddle	fiddled	fiddles	fiddling	fiddlings
blizzard	blizzards
accustom	accustomed	accustoming	accustoms
trilogy	trilogies
universally
chilly	chilliest	chillier
unfinished
nonstop
irritate	irritated	irritates	irritating
lineman
restrictive
distinctly
prosper	prospered	prospering	prospers
thirsty	thirstiest	thirstier
punt	punted	punting	punts
tidy	tidier	tidies	tidiest	tidied	tidying
livelihood	livelihoods
thinly
fashionable
obedience	obediences
bedtime	bedtimes
irregular	irregulars
hamper	hampered	hampering	hampers
obsolete
scalp	scalped	scalping	scalpings	scalps
inclination	inclinations
yearn	yearned	yearnings	yearns
temperament	temperaments
paperback	paperbacks
scotch	scotched	scotcher	scotches	scotching	scotchs
eyewitness	eyewitnesses
deliberation	deliberations
anyhow
syllable	syllables
predictive
shortcut	shortcuts
inauguration	inaugurations
brighten	brightened	brightening	brightens
ordeal	ordeals
blockbuster	blockbusters
wavelength	wavelengths
sag	sages	sagged	sagging	sags
regiment	regimented	regimenting	regiments
booze	boozed	boozes	boozing
checklist	checklists
orgasm	orgasms
southwestern	southwesterner
racing
relic	relics
dismay	dismayed	dismaying	dismays
candidacy	candidacies
nipple	nipples
caffeine	caffeines
heave	heaved	heaves	heavings	hove
tart	tarter	tartest	tarts
ninety	nineties
deteriorate	deteriorated	deteriorates	deteriorating
foliage	foliages
dropout	dropouts
unchanged
contour	contoured	contouring	contours
intruder	intruders
absorption	absorptions
monarch	monarchess	monarchs
matchup	matchups
methane	methanes
rancher	ranchers
facet	facets
ghetto	ghettoes	ghettos
patriotism	patriotisms
freight	freighted	freighting	freights
warden	wardens
motto	mottoes	mottos
exhaustion	exhaustions
latch	latched	latches	latching
collateral	collaterals
nervously
grievance	grievances
bodyguard	bodyguards
deity	deities
perish	perished	perishes	perishing
gunfire	gunfires
yea	yeas
feeding
graceful
gangster	gangsters
hallmark	hallmarks
famed
turnaround	turnarounds
indifference	indifferences
converge	converged	converges	converging
knob	knobs
sharing
wee	weeing	weer	wees	weest
cadet	cadets
thwart	thwarted	thwartings	thwarts
barge	barged	bargees	barges	barging
aquatic	aquatics
dwelling
boutique	boutiques
erotic	erotics
lastly
spec	specs
mantra	mantras
enormously
nightclub	nightclubs
pagan	pagans
superpower	superpowers
heading
pottery	potteries
exceptionally
nuance	nuances
cucumber	cucumbers
gin	ginned	ginning	gins
clutter	cluttered	cluttering	clutters
beginner	beginners
traction	tractions
strangle	strangled	strangles	stranglings
scenery	sceneries
wartime	wartimes
sentimental
episcopal
brutality	brutalities
terminology	terminologies
oblivious
downright
playful
blazer	blazers
crib	cribbed	cribbing	cribs
loot	looted	lootings	loots
assassinate	assassinated	assassinates	assassinating
keeping
grouping
abstraction	abstractions
collaborator	collaborators
volcanic
railway	railways
errand	errands
seriousness	seriousnesses
improper
insignificant
backer	backers
clump	clumped	clumping	clumps
unison	unisons
outset	outsets
headlight	headlights
jolt	jolted	jolting	jolts
containment	containments
playwright	playwrights
scrutinize	scrutinized	scrutinizes	scrutinizing
jab	jabbed	jabbing	jabs
robber	robbers
lavish	lavished	lavisher	lavishes	lavishest	lavishing
recognizable
mildly
weekday	weekdays
slit	sliting	slits	slitting
gland	glands
chromosome	chromosomes
oops
lefty	lefties
repertoire	repertoires
rainfall	rainfalls
recede	receded	recedes	receding
exquisite
watcher	watchers
messiah	messiahs
germ	germs
outdated
dismissal	dismissals
decidedly
unsafe	unsafer	unsafest
hassle	hassled	hassles	hassling
cavalry	cavalries
illicit
wonderfully
vocational
neon	neons
eccentric	eccentrics
nasal	nasals
glucose	glucoses
wrongdoing	wrongdoings
failing
goodwill	goodwills
hysterical
imaginative
hone	honed	hones	honing
pike	pikes
mosaic	mosaics
gorilla	gorillas
geological
forefront	forefronts
defer	deferred	deferring	defers
spreading
bandage	bandaged	bandages	bandaging
socket	sockets
seep	seeped	seeping	seeps
roadside	roadsides
refute	refuted	refutes	refuting
mundane	mundaner	mundanest
fulfillment	fulfillments
termination	terminations
chic	chicer	chicest	chics
coarse	coarser	coarsest
radiate	radiated	radiates	radiating
aspirin	aspirins
waterfall	waterfalls
yeast	yeasts
bloc	blocs
liaison	liaisons
shutter	shuttered	shuttering	shutterings	shutters
willingly
mailbox	mailboxes
bladder	bladders
devastation	devastations
successive
banish	banished	banishes	banishing
continuation	continuations
consolidation	consolidations
protector	protectors
preferably
bestow	bestowed	bestowing	bestows
heavyweight	heavyweights
maiden	maidens
exodus	exoduses
aquarium	aquaria	aquariums
attest	attested	attesting	attests
charcoal	charcoaled	charcoaling	charcoals
graffiti	graffitis
dispense	dispensed	dispenses	dispensing
grizzly	grizzlies	grizzliest	grizzlier
apocalypse	apocalypses
extinct
polo	polos
curry	curries	curried	currying	curryings
subgroup	subgroups
ruthless
populist	populists
ore	ores
mystical
beware	bewared	bewares	bewaring
doughnut	doughnuts
inflate	inflated	inflates	inflating
fiercely
eyeball	eyeballed	eyeballing	eyeballs
culprit	culprits
unravel	unraveled	unraveling	unravelled	unravelling	unravels
warranty	warranties
lava	lavas
vagina	vaginae	vaginas
mummy	mummies
cheerleader	cheerleaders
contentious
mingle	mingled	mingles	minglings
uneven	unevener	unevenest
seating
drainage	drainages
brandy	brandies
indifferent
menace	menaced	menaces	menacing
sexism	sexisms
charismatic
bowel	bowels
mapping	mappings
imprint	imprinted	imprintings	imprints
glamorous
burner	burners
patiently
plumbing
posit	posited	positing	posits
diver	divers	diverses
transcription	transcriptions
immortal	immortals
ottoman	ottomans
stature	statures
sharpen	sharpened	sharpening	sharpens
pecan	pecans
inconsistency	inconsistencies
cautiously
backstage
binoculars
washing
overtake	overtaken	overtakes	overtaking	overtook
misconception	misconceptions
satisfactory
reread	rereading	rereadings	rereads
righteousness	righteousnesses
semifinal	semifinals
alphabet	alphabets
sandal	sandals
souvenir	souvenirs
intrusion	intrusions
isle	isles
stylish
bulldog	bulldogging	bulldogs
infinity	infinities
arbitration	arbitrations
inward
axe
infuse	infused	infuses	infusing
dishonest
teller	tellers
versatile
landowner	landowners
finalist	finalists
softball	softballs
simultaneous
statistic	statistics
disarm	disarmed	disarming	disarms
almighty
ratify	ratifies	ratified	ratifying
overdose	overdosed	overdoses	overdosing
mop	mopeds	mopes	moping	mopped	mopping	mops
photon	photons
nonfiction	nonfictions
caucasian	caucasians
grieve	grieved	grieves	grieving
restart	restarted	restarting	restarts
midterm	midterms
bingo	bingos
angler	anglers
dreadful
preheat	preheated	preheating	preheats
rejoice	rejoiced	rejoices	rejoicings
skid	skidded	skidding	skids
wherein
pup	pupped	pupping	pups
watershed	watersheds
downstream
fortress	fortresses
fasten	fastened	fastenings	fastens
consulate	consulates
jasmine	jasmines
diving
baptism	baptisms
fin	fined	fines	finessed	finesses	finessing	fining	fins
tit	tits
dominion	dominions
hefty	heftiest	heftier
gypsy	gypsies
emulate	emulated	emulates	emulating
sift	sifted	siftings	sifts
imperfect	imperfects
affinity	affinities
billing
acknowledgment	acknowledgments
facade	facades
hoist	hoisted	hoisting	hoistings	hoists
concur	concurred	concurring	concurs
endlessly
competitiveness	competitivenesses
retrospect	retrospected	retrospecting	retrospects
indie	indies
denomination	denominations
avoidance	avoidances
monumental
infiltrate	infiltrated	infiltrates	infiltrating
gravy	gravies
rum	rums
influx	influxes
fluency	fluencies
wince	winced	winces	wincing	wincings
impede	impeded	impedes	impeding
longevity	longevities
tortilla	tortillas
limiting
savor	savored	savoring	savors
worsen	worsened	worseness	worsenesses	worsening	worsens
complementary	complementaries
primer	primers
displacement	displacements
proficiency	proficiencies
enlighten	enlightened	enlightening	enlightens
antioxidant	antioxidants
relaxation	relaxations
lavender	lavenders
fraternity	fraternities
junction	junctions
parachute	parachuted	parachutes	parachuting
gourmet	gourmets
lurch	lurched	lurches	lurching
grumble	grumbled	grumbles	grumblings
mediocre
tidal
differentiation	differentiations
numerical
boredom	boredoms
rename	renamed	renames	renaming
blatant
undecided
hierarchical
peacefully
aura	aurae	auras
frost	frosted	frosteds	frostings	frosts
spaghetti	spaghettis
swoop	swooped	swooping	swoops
stocking
insightful
zoning
gleam	gleamed	gleamings	gleams
tutorial	tutorials
unavailable
led	leds
mediation	mediations
cramp	cramped	cramping	cramps
maritime
wiggle	wiggled	wiggles	wiggling
placebo	placebos