ref	refs
pimp	pimped	pimping	pimps
jumper	jumpers
fragrance	fragrances
parrot	parroted	parroting	parrots
moderately
austerity	austerities
deprivation	deprivations
doubtful
broadcaster	broadcasters
clasp	clasped	clasping	claspings	clasps
austrian	austrians
sinister
augment	augmented	augmenting	augments
experimentation	experimentations
occupant	occupants
nebula	nebulae	nebulas
vie	vied	vies	vying
upscale
hypothesize	hypothesized	hypothesizes	hypothesizing
outnumber	outnumbered	outnumbering	outnumbers
ensue	ensued	ensues	ensuing
estrogen	estrogens
proactive
customary
unanimous
adorn	adorned	adorning	adorns
deacon	deacons
prominence	prominences
recruiter	recruiters
traverse	traversed	traverses	traversing	traversings
convoy	convoyed	convoying	convoys
halftime	halftimes
sanity	sanities
interruption	interruptions
encode	encoded	encodes	encodings
ledge	ledges
longing
pristine
sever	severed	severing	severs
tentative
traveling
tremendously
induction	inductions
mince	minced	minces	mincing	mincings
avalanche	avalanched	avalanches	avalanching
ion	ions
floral
fanatic	fanatics
hungarian	hungarians
gloss	glossed	glosses	glossing
sap	sapped	sapping	saps
misdemeanor	misdemeanors
clog	clogged	clogging	clogs
reuse	reused	reuses	reusing
shady	shadiest	shadier
limo	limos	limoses
cosmetic	cosmetics
dissident	dissidents
resilience	resiliences
guitarist	guitarists
childish
clam	clames	clammed	clamming	clams
inconvenience	inconvenienced	inconveniences	inconveniencing
confidentiality	confidentialities
granny	grannies
uphill	uphills
veer	veered	veerings	veers
slipper	slippers
powerless
commemorate	commemorated	commemorates	commemorating
clubhouse	clubhouses
metallic	metallics
procession	processions
tolerant
gladly
orchestrate	orchestrated	orchestrates	orchestrating
transitional
commonplace	commonplacer	commonplaces
celery	celeries
carpenter	carpentered	carpentering	carpenters
blender	blenders
dane	danes
diocese	dioceses
cleanse	cleansed	cleanses	cleansings
bitterness	bitternesses
bilingual	bilinguals
feud	feuded	feuding	feudings	feuds
satire	satires
memorandum	memorandums
logistics
promotional
insecure
amber	ambers
pulp	pulped	pulping	pulps
catholicism	catholicisms
indicative	indicatives
unpaid
crimson	crimsoned	crimsoning	crimsons
cocoa	cocoas
hateful
discrete	discreter	discretest
eradicate	eradicated	eradicates	eradicating
confide	confided	confides	confiding
jockey	jockeyed	jockeying	jockeys
evade	evaded	evades	evading
dresser	dressers
cannabis	cannabises
poisoning
tinker	tinkered	tinkering	tinkerings	tinkers
condemnation	condemnations
enrichment	enrichments
newsroom	newsrooms
injunction	injunctions
disposable	disposables
ballpark	ballparks
dilute	diluted	dilutees	diluter	dilutes	diluting
pageant	pageants
upside	upsides
smirk	smirked	smirking	smirks
flux	fluxed	fluxes	fluxing
alternatively
salty	saltiest	saltier
bliss	blisses
attribution	attributions
pivot	pivoted	pivoting	pivotings	pivots
treason	treasons
chimney	chimneys
fraudulent
disproportionate
pawn	pawned	pawning	pawns
metabolic
incarnation	incarnations
outsource	outsourced	outsources	outsourcing	outsourcings
pebble	pebbles
clench	clenched	clenches	clenching
bamboo	bamboos
dunk	dunked	dunking	dunks
unauthorized
gulp	gulped	gulping	gulps
renovate	renovated	renovates	renovating
ransom	ransomed	ransoming	ransoms
heighten	heightened	heightening	heightens
precipitation	precipitations
hugely
drizzle	drizzled	drizzles	drizzling
expansive
deportation	deportations
prudent
jesuit	jesuits
affidavit	affidavits
hash	hashed	hashes	hashing
motherhood	motherhoods
telegraph	telegraphed	telegrapheses	telegraphing	telegraphs
darken	darkened	darkening	darkens
blackmail	blackmailed	blackmailing	blackmails
postmodern
handwriting
demeanor	demeanors
plainly
clumsy	clumsiest	clumsier
whichever
adherence	adherences
flatter	flattered	flatteress	flattering	flatters
taunt	taunted	tauntings	taunts
congestion	congestions
folly	follies
shampoo	shampooed	shampooing	shampoos
sizable
unintended
mixer	mixers
curly	curliest	curlier
coating
ration	rationed	rationing	rations
outspoken
donkey	donkeys
gamma	gammas
replica	replicas	replicases
havoc	havocs
tasting
divisive
innate
nuke	nuked	nukes	nuking
blindness	blindnesses
vacancy	vacancies
waive	waived	waives	waiving
introductory
imprisonment	imprisonments
splinter	splintered	splintering	splinters
archaeology	archaeologies
cleric	clerics
puddle	puddled	puddles	puddling	puddlings
martini	martinis
helper	helpers
entertainer	entertainers
bogus
kosher	koshers
barren	barrener	barrenest	barrens
woodland	woodlands
thirst	thirsted	thirsting	thirsts
humorous
dysfunctional
scientifically
energize	energized	energizes	energizing
pollster	pollsters
snore	snored	snores	snorings
hairy	hairiest	hairier
backbone	backbones
ominous
substitution	substitutions
ceramic	ceramics
prioritize	prioritized	prioritizes	prioritizing
taboo	tabooed	tabooing	taboos
mute	muted	muter	mutes	mutest	muting
commercially
antiquity	antiquities
gateway	gateways
bisexual	bisexuals
lunatic	lunatics
ping	pinged	pinging	pings
outpost	outposts
testosterone	testosterones
buff	buffed	buffest	buffing	buffings	buffs
swat	swats	swatted	swatting
aroma	aromas
cornerback	cornerbacks
vinyl	vinyls
algae
shale	shales
dangerously
boob	boobed	boobing	boobs
restructure	restructured	restructures	restructuring	restructurings
semantic
automotive
slut	sluts
revert	reverted	reverting	reverts
insulation	insulations
lily	lilies
disseminate	disseminated	disseminates	disseminating
microbe	microbes
storyline	storylines
sighting
pursuant
windy	windiest	windier
witty	wittiest	wittier
dryer	dryers
pediatric
riches	richesses
materialize	materialized	materializes	materializing
authoritative
salsa	salsas
rover	rovers
pianist	pianists
solitude	solitudes
implicitly
bathtub	bathtubs
putt	putted	puttings	putts
pleasing
presbyterian	presbyterians
pueblo	pueblos
cortex	cortexes	cortices
apache	apaches
flea	fleas
derail	derailed	derailing	derails
climber	climbers
bikini	bikinis
nostril	nostrils
robotic
raising
presumption	presumptions
glamor	glamors
gust	gusts
levy	levies	levied	levying
payer	payers
eighteenth	eighteenths
speedy	speediest	speedier
diversify	diversifies	diversified	diversifying
sponsorship	sponsorships
improvise	improvised	improvises	improvising
asphalt	asphalted	asphalting	asphalts
ragged	raggeder	raggedest
moth	moths
climax	climaxed	climaxes	climaxing
utilization	utilizations
larva	larvae	larvas
jade	jaded	jades	jading
abrupt	abrupter	abruptest
logically
coroner	coroners
conspire	conspired	conspires	conspiring
soybean	soybeans
interdisciplinary
bog	bogs
decency	decencies
insurgency	insurgencies
centerpiece	centerpieces
coaster	coasters
brim	briming	brimings	brimmed	brimming	brims
refinery	refineries
firsthand
overload	overloaded	overloading	overloads
screenplay	screenplays
speculative
unofficial
pavilion	pavilions
drawback	drawbacks
broom	broomed	brooming	brooms
prod	prodded	prodding	prods
cranberry	cranberries
modernity	modernities
breadth	breadths
whim	whims
pilgrimage	pilgrimages
unnatural
refrigerate	refrigerated	refrigerates	refrigerating
furnace	furnaces
showdown	showdowns
shitty
nuisance	nuisances
crappy
handout	handouts
ascertain	ascertained	ascertaining	ascertains
noteworthy
yawn	yawned	yawnings	yawns
atheism	atheisms
ballad	ballads
pollute	polluted	pollutes	polluting
customize	customized	customizes	customizing
hygiene	hygienes
momentarily
esteem	esteemed	esteeming	esteems
lutheran	lutherans
ukrainian	ukrainians
futile	futiler	futilest
sushi	sushis
glossy	glossies	glossiest	glossier
gala	galas
handkerchief	handkerchiefs	handkerchieves
thaw	thawed	thawings	thaws
poop	poops
aforementioned
mailing
ostensibly
omission	omissions
fend	fended	fending	fends
racially
unborn
revealing
reaffirm	reaffirmed	reaffirming	reaffirms
entirety	entireties
hoax	hoaxed	hoaxes	hoaxing
fatality	fatalities
defiance	defiances
retrospective	retrospectives
emanate	emanated	emanates	emanating
miraculous
tuberculosis
hospice	hospices
foreground	foregrounded	foregrounding	foregrounds
persuasion	persuasions
cape
sabbath	sabbaths
eerie	eerier	eeriest
pathology	pathologies
anguish	anguished	anguishes	anguishing
waffle	waffled	waffles	waffling	wafflings
contraceptive	contraceptives
diffuse	diffused	diffuses	diffusing
reimbursement	reimbursements
slum	slummed	slumming	slums
unjust	unjuster	unjustest
ascend	ascended	ascending	ascends
shun	shunned	shunning	shuns
mediator	mediators
blocking
rusty	rustiest	rustier
precursor	precursors
invaluable
hesitant
beforehand
slay	slain	slayed	slayings	slays
paramedic	paramedics
evergreen	evergreens
timer	timers
pamphlet	pamphlets
macro	macros
diabetic	diabetics
disparate
reflex	reflexes
convertible	convertibles
symposium	symposia	symposiums
oppressive
expanse	expanses
annex	annexed	annexes	annexing
obscene	obscener	obscenest
abbey	abbeys
motorist	motorists
tad	tads
transcribe	transcribed	transcribes	transcribing
rodent	rodents
scenic
stutter	stuttered	stuttering	stutterings	stutters
edible	edibles
refresh	refreshed	refreshes	refreshing
demolish	demolished	demolishes	demolishing
eyelid	eyelids
chopper	choppers
compress	compressed	compresses	compressing
screech	screeched	screeches	screeching
bonding
surreal
verification	verifications
cliche	cliches
deflect	deflected	deflecting	deflects
pointer	pointers
inadvertently
moderation	moderations
collegiate
amass	amassed	amasses	amassing
vile	viler	vilest
fireman	firemen
skew	skewed	skewerer	skewest	skewing	skewings	skews
peacekeeping	peacekeepings
ballroom	ballrooms
burglary	burglaries
delve	delved	delves	delving
naughty	naughtiest	naughtier
cerebral
baker	bakers
profess	professed	professes	professing
corporal	corporals
horribly
faulty	faultiest	faultier
raspberry	raspberries
hymn	hymned	hymning	hymns
lining
quartet	quartets
bigotry	bigotries
lunge	lunged	lungees	lungeing	lunges	lunging
slur	slurred	slurring	slurs
overt	overtest
cartridge	cartridges
showbiz
tavern	taverns
thyme	thymes
squeal	squealed	squealing	squealings	squeals
quarrel	quarreled	quarreling	quarrelings	quarrelled	quarrelling	quarrels
abuser	abusers
filibuster	filibustered	filibustering	filibusterings	filibusters
sacrament	sacraments
solemn	solemner	solemnest
blueberry	blueberries
jihad	jihads
showing
abdominal	abdominals
ecstasy	ecstasies
construe	construed	construes	construing
leash	leashed	leashes	leashing
hijack	hijacked	hijackings	hijacks
herbal	herbals
banquet	banqueted	banquetings	banquets
scowl	scowled	scowling	scowls
vicinity	vicinities
pertinent
inscription	inscriptions
manually
ceremonial	ceremonials
subsection	subsections
fed	feds
paramount
blockade	blockaded	blockades	blockading
scorn	scorned	scorning	scornings	scorns
acquaint	acquainted	acquainting	acquaints
cove	coves
crackdown	crackdowns
blackout	blackouts
molest	molested	molesting	molests
wildfire	wildfires
earthly	earthliest	earthlier
assimilate	assimilated	assimilates	assimilating
textual
horrify	horrifies	horrified	horrifying
inefficient
petal	petals
hive	hived	hives	hiving
celestial
converse	conversed	converser	converses	conversing
goofy	goofiest	goofier
wreckage	wreckages
excursion	excursions
motivational
paranoia	paranoias
fucker	fuckers
morph	morphed	morphing	morphings	morphs
mileage	mileages
auditory
manure	manured	manures	manuring	manurings
felon	felons
holler	hollered	hollering	hollers
coercion	coercions
angrily
beacon	beaconed	beaconing	beacons
academia	academias
khan	khans
brutally
funky	funkiest	funkier
bedside	bedsides
header	headers
curtail	curtailed	curtailing	curtails
doctorate	doctorates
stepfather	stepfathers
holistic
unlawful
jointly
gleaming
intimidation	intimidations
chemist	chemists
timeless
nausea	nauseas
remorse	remorses
etch	etched	etches	etchings
pantry	pantries
taint	tainted	tainting	taints
fetal
steward	stewards
conditioner	conditioners
abdomen	abdomens
carcass	carcasses
fallacy	fallacies
liken	likened	likenesses	likening	likens
orbital
platinum	platinums
inhibitor	inhibitors
lighthouse	lighthouses
apparel	appareled	appareling	apparels
orphanage	orphanages
soothe	soothed	soothes	soothing	soothings
dealership	dealerships
immature
marrow	marrows
sweetness	sweetnesses
dagger	daggers
mow	mowed	mowing	mown	mows
poignant
clout	clouted	clouting	clouts
thicken	thickened	thickenings	thickens
farmhouse	farmhouses
obstruct	obstructed	obstructing	obstructs
fart	farted	farting	farts
clarification	clarifications
landslide	landslides
irresistible
trinity	trinities
careless
groundbreaking	groundbreakings
aerospace	aerospaces
rupture	ruptured	ruptures	rupturing
taco	tacos
plump	plumped	plumper	plumpest	plumping	plumps
upstate
serbian	serbians
repetitive
makeshift	makeshifts
cognition	cognitions
hater	haters
iceberg	icebergs
nominal	nominals
commend	commended	commending	commends
stealth	stealths
malicious
wane
queue	queued	queueings	queues	queuing	queuings
juggle	juggled	juggles	jugglings
brownie	brownies
curiously
immensely
starvation	starvations
rift	rifts
enclose	enclosed	encloses	enclosing
inspirational
beet	beets
pharmacist	pharmacists
amuse	amused	amuses	amusing
mammoth	mammoths
ailment	ailments
deductible	deductibles
platoon	platoons
crescent	crescents
stout	stouter	stoutest	stouts
unanswered
flinch	flinched	flinches	flinching	flinchings
quirky
bullpen	bullpens
prolong	prolonged	prolonges	prolonging	prolongs
neurological
abort	aborted	aborting	aborts
inception	inceptions
incremental
duel	dueled	dueling	duelings	duelled	duelling	duels
intolerance	intolerances
candid	candider	candidest
untouched
footing
kernel	kernels
infringement	infringements
fret	frets	fretted	fretting
greasy	greasiest	greasier
vibrate	vibrated	vibrates	vibrating
espouse	espoused	espouses	espousing
rocker	rockers
dissatisfaction	dissatisfactions
indispensable
stainless	stainlesses
barber	barbered	barberess	barbering	barbers
caveat	caveats
cassette	cassettes
belgian	belgians
slew	slewed	slewing	slews
hypocrite	hypocrites
fluffy	fluffiest	fluffier
horde	hordes
ancestral
scoff	scoffed	scoffings	scoffs
beaver	beavered	beavering	beavers
cilantro	cilantros
clueless
graveyard	graveyards
resilient
receptive
devoid
stockpile	stockpiled	stockpiles	stockpilings
ramification	ramifications
indonesian	indonesians
modernist	modernists
shroud	shrouded	shrouding	shroudings	shrouds
analogous
existential
porcelain	porcelains
rearrange	rearranged	rearranges	rearranging
murky	murkiest	murkier
punitive
upheaval	upheavals
symbolism	symbolisms
barefoot
rigor	rigors
undercut	undercuts	undercutting
unreliable
mike	mikes
rout	routed	routes	routing	routings	routs
restroom	restrooms
interrogate	interrogated	interrogatees	interrogates	interrogating
vitality	vitalities
biomass	biomasses
combo	combos
pigment	pigmented	pigmenting	pigments
debacle	debacles
unconventional
plume	plumed	plumes	pluming
entice	enticed	entices	enticing	enticings
stale	staled	staler	stales	stalest	staling
wallpaper	wallpapered	wallpapering	wallpapers
casket	casketed	casketing	caskets
addictive
sect	sects
gothic	gothics
snarl	snarled	snarling	snarlings	snarls
dearly
obligate	obligated	obligates	obligating
hem	hemmed	hemming	hems
subside	subsided	subsides	subsiding
configure	configured	configures	configuring
debtor	debtors
homage	homages
squeak	squeaked	squeaking	squeakings	squeaks
mathematician	mathematicians
scorer	scorers
spoiler	spoilers
spout	spouted	spouting	spoutings	spouts
eldest
fluorescent	fluorescents
carving
battleground	battlegrounds
healer	healers
pun	punned	punning	puns
marginalize	marginalized	marginalizes	marginalizing
cringe	cringed	cringes	cringing	cringings
invader	invaders
hypertension	hypertensions
alpine
admirable
hideous
safari	safaris
narrate	narrated	narrates	narrating
outage	outages
coping
usefulness	usefulnesses
unsettle	unsettled	unsettles	unsettling	unsettlings
daring
psychologically
squadron	squadrons
ballistic
heartbreaking
borrowing
noun	nouns
nonviolent
unfairly
scour	scoured	scouress	scourings	scours
grimace	grimaced	grimaces	grimacing
camouflage	camouflaged	camouflages	camouflaging
pineapple	pineapples
thermometer	thermometers
convergence	convergences
mash	mashed	mashes	mashing	mashings
impart	imparted	imparting	imparts
rhythmic
gazette	gazetted	gazettes	gazetting
incorrectly
irritation	irritations
richness	richnesses
bourgeois	bourgeoises
cupcake	cupcakes
fern	ferns
monarchy	monarchies
fray	frayed	fraying	frayings	frays
falsely
tibetan	tibetans
luxurious
flute	fluted	flutes	flutings
neutron	neutrons
junkie
underline	underlined	underlines	underlining	underlinings
bellow	bellowed	bellowing	bellows
confiscate	confiscated	confiscates	confiscating
sanitation	sanitations
pouch	pouched	pouches	pouching
upbeat	upbeats
mogul	moguls
crackle	crackled	crackles	crackless	cracklings
shameful
computational
specificity	specificities
embodiment	embodiments
treadmill	treadmills
prank	pranked	pranking	prankings	pranks
mango	mangoes	mangos
flagship	flagships
sparkling
strategically
farmland	farmlands
magnify	magnifies	magnified	magnifying
caliber	calibers
amidst
sterile
accreditation	accreditations
poisonous
subtract	subtracted	subtracting	subtracts
breathtaking
odyssey	odysseys
modernization	modernizations
appetizer	appetizers
cultivation	cultivations
abduction	abductions
affirmation	affirmations
upwards
coax	coaxed	coaxes	coaxing
breaker	breakers
proclamation	proclamations
bristle	bristled	bristles	bristling
repository	repositories
fearless
earmark	earmarked	earmarking	earmarkings	earmarks
caravan	caravaned	caravaning	caravans
simplistic
narration	narrations
coronary	coronaries
nestle	nestled	nestles	nestlings
masculinity	masculinities
unthinkable
therein
equitable
snail	snailed	snailing	snails
gentile	gentiles	gentilesses
obsessive	obsessives
skyrocket	skyrocketed	skyrocketing	skyrockets
ancestry	ancestries
camper	campers
ark	arks
cornerstone	cornerstones
voltage	voltages
alibi	alibied	alibies	alibiing	alibis
confinement	confinements
emptiness	emptinesses
dogma	dogmas	dogmata
abduct	abducted	abducting	abducts
gorge	gorged	gorges	gorging
hump	humped	humping	humps
getaway	getaways
deli	delis
mend	mended	mendings	mends
adjective	adjectives
gloom	glooms
homestead	homesteaded	homesteading	homesteadings	homesteads
proportional	proportionals
exhale	exhaled	exhales	exhaling
calculator	calculators
unnoticed
jug	jugged	jugging	jugs
consolation	consolations
midday	middays
ultrasound	ultrasounds
realist	realists
cupboard	cupboards
throttle	throttled	throttles	throttlings
infinitely
torpedo	torpedoed	torpedoes	torpedoing	torpedos
truthful
electromagnetic
overshadow	overshadowed	overshadowing	overshadows
colonist	colonists
scarcity	scarcities
ale	ales
upbringing	upbringings
propensity	propensities
detrimental
californian	californians
dismal	dismaler	dismalest
conveniently
academically
anthology	anthologies
overrun	overran	overrunning	overruns
assortment	assortments
lofty	loftiest	loftier
seasoning
oust	ousted	ousting	ousts
powerhouse	powerhouses
finishing
destroyer	destroyers
provisional
determinant	determinants
reshape	reshaped	reshapes	reshaping
vanguard	vanguards
nigerian	nigerians
backfire	backfired	backfires	backfiring
scribble	scribbled	scribbles	scribbling	scribblings
harp	harped	harping	harpings	harps
barricade	barricaded	barricades	barricading
anti	antis
elude	eluded	eludes	eluding
mindful
ethiopian	ethiopians
sculptor	sculptors
unmarried
kite
counterterrorism	counterterrorisms
locus	loci
freshwater	freshwaters
timetable	timetables
bouquet	bouquets
sociologist	sociologists
federally
kinship	kinships
relegate	relegated	relegates	relegating
emerald	emeralds
downplay	downplayed	downplaying	downplays
monologue	monologues
transient	transients
wasp	wasps
salient	salients
reappear	reappeared	reappearing	reappears
lemonade	lemonades
nylon	nylons
confound	confounded	confounding	confounds
paraphrase	paraphrased	paraphrases	paraphrasing
watchdog	watchdogs
messaging
guise	guises
piston	pistons
predicament	predicaments
drugstore	drugstores
tedious
nighttime	nighttimes
incarceration	incarcerations
kayak	kayaked	kayaking	kayakings	kayaks
undertaking
fang	fangs
grope	groped	gropes	groping	gropings
unpack	unpacked	unpacking	unpackings	unpacks
frantically
upstream
incompatible
classy	classiest	classier
ordinarily
redirect	redirected	redirecting	redirects
vowel	vowels
avocado	avocados
invalid	invalided	invaliding	invalidings	invalids
biopsy	biopsies
alligator	alligatored	alligatoring	alligators
whereabouts
bleach	bleached	bleaches	bleaching	bleachings	bleachs
garner	garnered	garnering	garners
thyroid	thyroids
dreamer	dreamers
storyteller	storytellers
journalistic
melting
bitterly
tyrant	tyrants
swath	swaths
entrust	entrusted	entrusting	entrusts
cider	ciders
prominently
goodnight
plumber	plumbers
racket	racketed	racketing	rackets
monstrous
continual
deterioration	deteriorations
decor	decors
likeness
trendy	trendiest	trendier
soprano	soprani	sopranos
whoop	whooped	whooping	whoopings	whoops
baptize	baptized	baptizes	baptizing
beckon	beckoned	beckoning	beckons
geologist	geologists
chestnut	chestnuts
tanker	tankers
berth	berthed	berthes	berthing	berths
cactus	cacti	cactuses
fabricate	fabricated	fabricates	fabricating
bipolar
tote
biker
alcoholism	alcoholisms
forage	foraged	forages	foraging
gymnastics
melancholy	melancholies
caretaker	caretakers
ringing
vantage	vantages
relinquish	relinquished	relinquishes	relinquishing
brilliance	brilliances
gutter	guttered	guttering	gutterings	gutters
lawful
breeder	breeders
attainment	attainments
connectivity	connectivities
humanist	humanists
incompetence	incompetences
ammo	ammos
insofar
attire	attired	attires	attiring	attirings
revoke	revoked	revokes	revoking
statesman	statesmen
viability	viabilities
artisan	artisans
corpus	corpora	corpuses
lander	landers
burrow	burrowed	burrowing	burrows
intimately
disco	discoed	discoing	discos
informational
lookout	lookouts
excavation	excavations
violet	violets
flurry	flurries	flurried	flurrying
picket	picketed	picketing	pickets
marking
sophistication	sophistications
warhead	warheads
stripper	strippers
pollen	pollens
spacious
acorn	acorns
glee	glees
supremacy	supremacies
instinctively
repercussion	repercussions
flashback	flashbacks
homelessness	homelessnesses
swelling
strut	struts	strutted	strutting
herring	herrings
anecdotal
bland	blander	blandest
outburst	outbursts
adultery	adulteries
racer	racers
chile	chiles
dialect	dialects
subtly
neutralize	neutralized	neutralizes	neutralizing
magically
magistrate	magistrates
garrison	garrisoned	garrisoning	garrisons
knowingly
terrestrial
metaphysical
blitz	blitzed	blitzes	blitzing